,id,release_date,movie,production_budget,domestic_gross,worldwide_gross,profit,release_month,foreign_gross,release_year,ROI
0,1,2009-12-18,Avatar,425000000,760507625,2776345279,2351345279,12,2015837654,2009,553.2577127058823
1,2,2011-05-20,Pirates of the Caribbean: On Stranger Tides,410600000,241063875,1045663875,635063875,5,804600000,2011,154.6672856794934
2,3,2019-06-07,Dark Phoenix,350000000,42762350,149762350,-200237650,6,107000000,2019,-57.21075714285714
3,4,2015-05-01,Avengers: Age of Ultron,330600000,459005868,1403013963,1072413963,5,944008095,2015,324.38413883847545
4,5,2017-12-15,Star Wars Ep. VIII: The Last Jedi,317000000,620181382,1316721747,999721747,12,696540365,2017,315.3696362776025
5,6,2015-12-18,Star Wars Ep. VII: The Force Awakens,306000000,936662225,2053311220,1747311220,12,1116648995,2015,571.0167385620915
6,7,2018-04-27,Avengers: Infinity War,300000000,678815482,2048134200,1748134200,4,1369318718,2018,582.7114
7,8,2007-05-24,Pirates of the Caribbean: At Worldâs End,300000000,309420425,963420425,663420425,5,654000000,2007,221.14014166666664
8,9,2017-11-17,Justice League,300000000,229024295,655945209,355945209,11,426920914,2017,118.64840299999999
9,10,2015-11-06,Spectre,300000000,200074175,879620923,579620923,11,679546748,2015,193.20697433333333
10,11,2012-07-20,The Dark Knight Rises,275000000,448139099,1084439099,809439099,7,636300000,2012,294.3414905454545
11,12,2018-05-25,Solo: A Star Wars Story,275000000,213767512,393151347,118151347,5,179383835,2018,42.96412618181818
12,13,2013-07-02,The Lone Ranger,275000000,89302115,260002115,-14997885,7,170700000,2013,-5.453776363636364
13,14,2012-03-09,John Carter,275000000,73058679,282778100,7778100,3,209719421,2012,2.8284
14,15,2010-11-24,Tangled,260000000,200821936,586477240,326477240,11,385655304,2010,125.56816923076923
15,16,2007-05-04,Spider-Man 3,258000000,336530303,894860230,636860230,5,558329927,2007,246.84505038759693
16,17,2016-05-06,Captain America: Civil War,250000000,408084349,1140069413,890069413,5,731985064,2016,356.0277652
17,18,2016-03-25,Batman v Superman: Dawn of Justice,250000000,330360194,867500281,617500281,3,537140087,2016,247.0001124
18,19,2012-12-14,The Hobbit: An Unexpected Journey,250000000,303003568,1017003568,767003568,12,714000000,2012,306.80142720000003
19,20,2009-07-15,Harry Potter and the Half-Blood Prince,250000000,302089278,935213767,685213767,7,633124489,2009,274.0855068
20,21,2013-12-13,The Hobbit: The Desolation of Smaug,250000000,258366855,960366855,710366855,12,702000000,2013,284.14674199999996
21,22,2014-12-17,The Hobbit: The Battle of the Five Armies,250000000,255119788,945577621,695577621,12,690457833,2014,278.23104839999996
22,23,2017-04-14,The Fate of the Furious,250000000,225764765,1234846267,984846267,4,1009081502,2017,393.9385068
23,24,2006-06-28,Superman Returns,232000000,200120000,374085065,142085065,6,173965065,2006,61.2435625
24,25,2017-05-26,Pirates of the Caribbean: Dead Men Tell No Tales,230000000,172558876,788241137,558241137,5,615682261,2017,242.71353782608696
25,26,2008-11-14,Quantum of Solace,230000000,169368427,591692078,361692078,11,422323651,2008,157.2574252173913
26,27,2012-05-04,The Avengers,225000000,623279547,1517935897,1292935897,5,894656350,2012,574.6381764444444
27,28,2006-07-07,Pirates of the Caribbean: Dead Manâs Chest,225000000,423315812,1066215812,841215812,7,642900000,2006,373.87369422222224
28,29,2013-06-14,Man of Steel,225000000,291045518,667999518,442999518,6,376954000,2013,196.88867466666667
29,30,2008-05-16,The Chronicles of Narnia: Prince Caspian,225000000,141621490,417341288,192341288,5,275719798,2008,85.4850168888889
30,31,2012-07-03,The Amazing Spider-Man,220000000,262030663,757890267,537890267,7,495859604,2012,244.4955759090909
31,32,2012-05-18,Battleship,220000000,65233400,313477717,93477717,5,248244317,2012,42.48987136363636
32,33,2017-06-21,Transformers: The Last Knight,217000000,130168683,602893340,385893340,6,472724657,2017,177.8310322580645
33,34,2015-06-12,Jurassic World,215000000,652270625,1648854864,1433854864,6,996584239,2015,666.9092390697674
34,35,2012-05-25,Men in Black 3,215000000,179020854,654213485,439213485,5,475192631,2012,204.2853418604651
35,36,2009-06-24,Transformers: Revenge of the Fallen,210000000,402111870,836519699,626519699,6,434407829,2009,298.34271380952384
36,37,2014-06-27,Transformers: Age of Extinction,210000000,245439076,1104039076,894039076,6,858600000,2014,425.7328933333333
37,38,2006-05-26,X-Men: The Last Stand,210000000,234362462,459260946,249260946,5,224898484,2006,118.69568857142858
38,39,2010-05-14,Robin Hood,210000000,105487148,322459006,112459006,5,216971858,2010,53.551907619047626
39,40,2005-12-14,King Kong,207000000,218080025,550517357,343517357,12,332437332,2005,165.95041400966184
40,41,2007-12-07,The Golden Compass,205000000,70107728,367262558,162262558,12,297154830,2007,79.15246731707317
41,42,2018-02-16,Black Panther,200000000,700059566,1348258224,1148258224,2,648198658,2018,574.129112
42,43,1997-12-19,Titanic,200000000,659363944,2208208395,2008208395,12,1548844451,1997,1004.1041975
43,44,2018-06-15,Incredibles 2,200000000,608581744,1242520711,1042520711,6,633938967,2018,521.2603555000001
44,45,2016-12-16,Rogue One: A Star Wars Story,200000000,532177324,1049102856,849102856,12,516925532,2016,424.551428
45,46,2016-06-17,Finding Dory,200000000,486295561,1021215193,821215193,6,534919632,2016,410.60759649999994
46,47,2010-06-18,Toy Story 3,200000000,415004880,1068879522,868879522,6,653874642,2010,434.439761
47,48,2013-05-03,Iron Man 3,200000000,408992272,1215392272,1015392272,5,806400000,2013,507.696136
48,49,2017-05-05,Guardians of the Galaxy Vol 2,200000000,389813101,862316233,662316233,5,472503132,2017,331.1581165
49,50,2004-06-30,Spider-Man 2,200000000,373524485,795110670,595110670,6,421586185,2004,297.555335
50,51,2010-03-05,Alice in Wonderland,200000000,334191110,1025491110,825491110,3,691300000,2010,412.74555499999997
51,52,2012-11-08,Skyfall,200000000,304360277,1110526981,910526981,11,806166704,2012,455.2634905
52,53,2013-06-21,Monsters University,200000000,268488329,743588329,543588329,6,475100000,2013,271.79416449999997
53,54,2013-03-08,Oz the Great and Powerful,200000000,234770996,490359051,290359051,3,255588055,2013,145.17952549999998
54,55,2014-05-23,X-Men: Days of Future Past,200000000,233921534,747862775,547862775,5,513941241,2014,273.9313875
55,56,2014-05-02,The Amazing Spider-Man 2,200000000,202853933,708996336,508996336,5,506142403,2014,254.498168
56,57,2011-06-24,Cars 2,200000000,191450875,560155383,360155383,6,368704508,2011,180.0776915
57,58,2010-12-17,Tron: Legacy,200000000,172062763,400062763,200062763,12,228000000,2010,100.0313815
58,59,2009-11-13,2012,200000000,166112167,757677748,557677748,11,591565581,2009,278.838874
59,60,2018-11-16,Fantastic Beasts: The Crimes of Grindelwald,200000000,159555901,652220086,452220086,11,492664185,2018,226.110043
60,61,2009-05-21,Terminator Salvation,200000000,125322469,365491792,165491792,5,240169323,2009,82.745896
61,62,2011-06-17,Green Lantern,200000000,116601172,219535492,19535492,6,102934320,2011,9.767745999999999
62,63,2010-05-28,Prince of Persia: Sands of Time,200000000,90759676,336359676,136359676,5,245600000,2010,68.179838
63,64,2011-06-29,Transformers: Dark of the Moon,195000000,352390543,1123790543,928790543,6,771400000,2011,476.3028425641026
64,65,2017-06-09,The Mummy,195000000,80101125,409953905,214953905,6,329852780,2017,110.23277179487178
65,66,2013-03-01,Jack the Giant Slayer,195000000,65187603,197687603,2687603,3,132500000,2013,1.3782579487179487
66,67,2015-04-03,Furious 7,190000000,353007020,1518722794,1328722794,4,1165715774,2015,699.3277863157895
67,68,2013-05-16,Star Trek Into Darkness,190000000,228778661,467381584,277381584,5,238602923,2013,145.99030736842104
68,69,2013-06-21,World War Z,190000000,202359711,531514650,341514650,6,329154939,2013,179.74455263157896
69,70,2013-05-10,The Great Gatsby,190000000,144840419,351040419,161040419,5,206200000,2013,84.75811526315789
70,71,2009-11-06,Disneyâs A Christmas Carol,190000000,137855863,315709697,125709697,11,177853834,2009,66.16299842105263
71,72,2013-07-12,Pacific Rim,190000000,101802906,411002906,221002906,7,309200000,2013,116.31731894736843
72,73,2015-11-25,The Good Dinosaur,187500000,123087120,333771037,146271037,11,210683917,2015,78.01121973333333
73,74,2008-05-02,Iron Man,186000000,318604126,585171547,399171547,5,266567421,2008,214.60835860215056
74,75,2008-07-18,The Dark Knight,185000000,533720947,1001996207,816996207,7,468275260,2008,441.61957135135134
75,76,2008-05-22,Indiana Jones and the Kingdom of the Crystal Skull,185000000,317101119,786635413,601635413,5,469534294,2008,325.2083313513514
76,77,2012-06-22,Brave,185000000,237282182,554606532,369606532,6,317324350,2012,199.7873145945946
77,78,2017-03-10,Kong: Skull Island,185000000,168052812,561072059,376072059,3,393019247,2017,203.28219405405403
78,79,2016-07-22,Star Trek Beyond,185000000,158848340,335802233,150802233,7,176953893,2016,81.51472054054054
79,80,2017-10-06,Blade Runner 2049,185000000,92054159,259357408,74357408,10,167303249,2017,40.19319351351351
80,81,2019-05-24,Aladdin,182000000,246734314,619234314,437234314,5,372500000,2019,240.23863406593406
81,82,2017-11-03,Thor: Ragnarok,180000000,315058289,846980024,666980024,11,531921735,2017,370.5444577777778
82,83,2005-12-09,"The Chronicles of Narnia: The Lion, the Witch and the Wardrobe",180000000,291710957,720539572,540539572,12,428828615,2005,300.2997622222222
83,84,2014-05-30,Maleficent,180000000,241407328,758536735,578536735,5,517129407,2014,321.4092972222222
84,85,2016-11-18,Fantastic Beasts and Where to Find Them,180000000,234037575,802402853,622402853,11,568365278,2016,345.7793627777778
85,86,2008-06-27,WALL-E,180000000,223808164,532508025,352508025,6,308699861,2008,195.83779166666665
86,87,2007-08-10,Rush Hour 3,180000000,140125968,256585882,76585882,8,116459914,2007,42.54771222222222
87,88,2016-07-01,The Legend of Tarzan,180000000,126643061,348902025,168902025,7,222258964,2016,93.83445833333333
88,89,2011-11-23,Hugo,180000000,73864507,180047784,47784,11,106183277,2011,0.026546666666666666
89,90,2017-07-21,Valerian and the City of a Thousand Planets,180000000,40479370,215098356,35098356,7,174618986,2017,19.499086666666667
90,91,2015-02-06,Jupiter Ascending,179000000,47482519,181982519,2982519,2,134500000,2015,1.6662117318435754
91,92,2018-07-27,Mission: ImpossibleâFallout,178000000,220159104,787456552,609456552,7,567297448,2018,342.3913213483146
92,93,2016-05-27,X-Men: Apocalypse,178000000,155442489,542537546,364537546,5,387095057,2016,204.79637415730338
93,94,2018-08-10,The Meg,178000000,145443742,529530715,351530715,8,384086973,2018,197.48916573033708
94,95,2014-06-06,Edge of Tomorrow,178000000,100206256,370541256,192541256,6,270335000,2014,108.16924494382023
95,96,2019-03-08,Captain Marvel,175000000,426525952,1123061550,948061550,3,696535598,2019,541.7494571428572
96,97,2016-04-15,The Jungle Book,175000000,364001123,962854547,787854547,4,598853424,2016,450.2025982857143
97,98,2015-06-19,Inside Out,175000000,356461711,854235992,679235992,6,497774281,2015,388.1348525714286
98,99,2017-07-07,Spider-Man: Homecoming,175000000,334201140,880166350,705166350,7,545965210,2017,402.9522
99,100,2016-08-05,Suicide Squad,175000000,325100054,746059887,571059887,8,420959833,2016,326.31993542857145
100,1,2009-05-29,Up,175000000,293004164,731463377,556463377,5,438459213,2009,317.97907257142856
101,2,2017-11-22,Coco,175000000,209726015,798008101,623008101,11,588282086,2017,356.00462914285714
102,3,2018-11-21,Ralph Breaks The Internet,175000000,201091711,524283695,349283695,11,323191984,2018,199.59068285714287
103,4,2009-03-27,Monsters vs. Aliens,175000000,198351526,381687380,206687380,3,183335854,2009,118.10707428571428
104,5,2017-06-16,Cars 3,175000000,152901115,383541369,208541369,6,230640254,2017,119.16649657142857
105,6,2009-08-07,G.I. Joe: The Rise of Cobra,175000000,150201498,302469017,127469017,8,152267519,2009,72.83943828571428
106,7,1999-06-30,Wild Wild West,175000000,113805681,221229335,46229335,6,107423654,1999,26.416762857142857
107,8,2008-08-01,The Mummy: Tomb of the Dragon Emperor,175000000,102491776,405760225,230760225,8,303268449,2008,131.8629857142857
108,9,2007-06-22,Evan Almighty,175000000,100289690,174131329,-868671,6,73841639,2007,-0.4963834285714286
109,10,1995-07-28,Waterworld,175000000,88246220,264246220,89246220,7,176000000,1995,50.997840000000004
110,11,2017-05-12,King Arthur: Legend of the Sword,175000000,39175066,139630336,-35369664,5,100455270,2017,-20.21123657142857
111,12,2013-12-25,47 Ronin,175000000,38362475,151716815,-23283185,12,113354340,2013,-13.304677142857143
112,13,2018-06-22,Jurassic World: Fallen Kingdom,170000000,417719760,1305772799,1135772799,6,888053039,2018,668.1016464705882
113,14,2014-08-01,Guardians of the Galaxy,170000000,333172112,770867516,600867516,8,437695404,2014,353.45148
114,15,2010-05-07,Iron Man 2,170000000,312433331,621156389,451156389,5,308723058,2010,265.3861111764706
115,16,2014-04-04,Captain America: The Winter Soldier,170000000,259746958,714401889,544401889,4,454654931,2014,320.2364052941177
116,17,2014-07-11,Dawn of the Planet of the Apes,170000000,208545589,710644566,540644566,7,502098977,2014,318.02621529411766
117,18,2004-11-10,The Polar Express,170000000,187224605,311365187,141365187,11,124140582,2004,83.15599235294118
118,19,2012-06-01,Snow White and the Huntsman,170000000,155136755,401021746,231021746,6,245884991,2012,135.89514470588236
119,20,2003-07-01,Terminator 3: Rise of the Machines,170000000,150358296,433058296,263058296,7,282700000,2003,154.74017411764706
120,21,2004-05-07,Van Helsing,170000000,120150546,300150546,130150546,5,180000000,2004,76.55914470588236
121,22,2019-03-29,Dumbo,170000000,113883318,345004422,175004422,3,231121104,2019,102.94377764705882
122,23,2015-05-22,Tomorrowland,170000000,93436322,206627518,36627518,5,113191196,2015,21.54559882352941
123,24,2019-02-14,Alita: Battle Angel,170000000,85710210,402976036,232976036,2,317265826,2019,137.04472705882353
124,25,2019-05-31,Godzilla: King of the Monsters,170000000,85576941,299276941,129276941,5,213700000,2019,76.0452594117647
125,26,2016-05-27,Alice Through the Looking Glass,170000000,77042381,276928112,106928112,5,199885731,2016,62.8988894117647
126,27,2010-05-21,Shrek Forever After,165000000,238736787,756244673,591244673,5,517507886,2010,358.3301048484849
127,28,2016-11-04,Doctor Strange,165000000,232641920,676404566,511404566,11,443762646,2016,309.94216121212116
128,29,2014-11-07,Big Hero 6,165000000,222527828,652127828,487127828,11,429600000,2014,295.2289866666667
129,30,2010-03-26,How to Train Your Dragon,165000000,217581232,494870992,329870992,3,277289760,2010,199.92181333333335
130,31,2012-11-02,Wreck-It Ralph,165000000,189412677,496511521,331511521,11,307098844,2012,200.91607333333332
131,32,2014-11-05,Interstellar,165000000,188017894,666379375,501379375,11,478361481,2014,303.8662878787879
132,33,2016-06-24,Independence Day: Resurgence,165000000,103144286,384169424,219169424,6,281025138,2016,132.82995393939393
133,34,2011-07-29,Cowboys and Aliens,163000000,100368560,176038324,13038324,7,75669764,2011,7.998971779141105
134,35,2017-03-17,Beauty and the Beast,160000000,504014165,1259199706,1099199706,3,755185541,2017,686.99981625
135,36,2018-12-21,Aquaman,160000000,335061807,1146894640,986894640,12,811832833,2018,616.80915
136,37,2007-05-17,Shrek the Third,160000000,322719944,807330936,647330936,5,484610992,2007,404.581835
137,38,2010-07-16,Inception,160000000,292576195,835524642,675524642,7,542948447,2010,422.20290125
138,39,2015-11-20,The Hunger Games: Mockingjay - Part 2,160000000,281723902,648986787,488986787,11,367262885,2015,305.616741875
139,40,2013-05-24,Fast and Furious 6,160000000,238679850,789300444,629300444,5,550620594,2013,393.3127775
140,41,2014-05-16,Godzilla,160000000,200676069,529076069,369076069,5,328400000,2014,230.67254312499998
141,42,2011-06-03,X-Men: First Class,160000000,146408305,355408305,195408305,6,209000000,2011,122.13019062499998
142,43,2008-12-25,The Curious Case of Benjamin Button,160000000,127509326,329631958,169631958,12,202122632,2008,106.01997375
143,44,2010-07-14,The Sorcerer's Apprentice,160000000,63150991,217986320,57986320,7,154835329,2010,36.24145
144,45,2006-05-12,Poseidon,160000000,60674817,181674817,21674817,5,121000000,2006,13.546760625000001
145,46,2016-06-10,Warcraft,160000000,47225655,425522281,265522281,6,378296626,2016,165.951425625
146,47,2016-09-30,Deepwater Horizon,156000000,61433527,122603824,-33396176,9,61170297,2016,-21.40780512820513
147,48,2010-12-10,The Chronicles of Narnia: The Voyage of the Dawn Treader,155000000,104386950,418186950,263186950,12,313800000,2010,169.79803225806452
148,49,2015-07-01,Terminator: Genisys,155000000,89760956,432150894,277150894,7,342389938,2015,178.80702838709678
149,50,2018-03-23,Pacific Rim: Uprising,155000000,59874525,290930148,135930148,3,231055623,2018,87.69686967741936
150,51,2004-11-24,Alexander,155000000,34297191,167297191,12297191,11,133000000,2004,7.933671612903225
151,52,2017-07-14,War for the Planet of the Apes,152000000,146880162,489592267,337592267,7,342712105,2017,222.10017565789474
152,53,2001-05-25,Pearl Harbor,151500000,198539855,449239855,297739855,5,250700000,2001,196.52795709570955
153,54,2007-07-02,Transformers,151000000,319246193,708272592,557272592,7,389026399,2007,369.0546966887417
154,55,2017-06-02,Wonder Woman,150000000,412563408,821133378,671133378,6,408569970,2017,447.42225199999996
155,56,2013-11-22,Frozen,150000000,400738009,1272469910,1122469910,11,871731901,2013,748.3132733333333
156,57,2016-03-04,Zootopia,150000000,341268248,1019429616,869429616,3,678161368,2016,579.6197440000001
157,58,2007-07-11,Harry Potter and the Order of the Phoenix,150000000,292137260,943076457,793076457,7,650939197,2007,528.717638
158,59,2005-11-18,Harry Potter and the Goblet of Fire,150000000,290201752,897099794,747099794,11,606898042,2005,498.0665293333334
159,60,2003-05-15,The Matrix Reloaded,150000000,281553689,738576929,588576929,5,457023240,2003,392.3846193333334
160,61,2007-12-14,I am Legend,150000000,256393010,585532684,435532684,12,329139674,2007,290.35512266666666
161,62,2016-11-23,Moana,150000000,248757044,637517365,487517365,11,388760321,2016,325.01157666666666
162,63,2008-07-01,Hancock,150000000,227946274,624234272,474234272,7,396287998,2008,316.15618133333334
163,64,2005-07-15,Charlie and the Chocolate Factory,150000000,206459076,475825484,325825484,7,269366408,2005,217.21698933333334
164,65,2007-06-29,Ratatouille,150000000,206445654,626549695,476549695,6,420104041,2007,317.69979666666666
165,66,2013-11-08,Thor: The Dark World,150000000,206362140,644602516,494602516,11,438240376,2013,329.7350106666667
166,67,2005-06-15,Batman Begins,150000000,205343774,359142722,209142722,6,153798948,2005,139.42848133333334
167,68,2015-07-31,Mission: ImpossibleâRogue Nation,150000000,195042377,688858992,538858992,7,493816615,2015,359.239328
168,69,2017-07-21,Dunkirk,150000000,190068280,499837368,349837368,7,309769088,2017,233.22491200000002
169,70,2011-05-06,Thor,150000000,181030624,449326618,299326618,5,268295994,2011,199.55107866666665
170,71,2008-11-07,Madagascar: Escape 2 Africa,150000000,180174880,599680774,449680774,11,419505894,2008,299.78718266666664
171,72,2009-05-01,X-Men Origins: Wolverine,150000000,179883157,374825760,224825760,5,194942603,2009,149.88384
172,73,2009-05-22,Night at the Museum: Battle of the Smithsonian,150000000,177243721,402231063,252231063,5,224987342,2009,168.154042
173,74,2011-05-26,Kung Fu Panda 2,150000000,165249063,664837547,514837547,5,499588484,2011,343.22503133333333
174,75,2015-05-15,Mad Max: Fury Road,150000000,153636354,370098020,220098020,5,216461666,2015,146.73201333333336
175,76,2019-05-10,PokÃ©mon: Detective Pikachu,150000000,139507806,411258433,261258433,5,271750627,2019,174.17228866666667
176,77,2003-11-05,The Matrix Revolutions,150000000,139270910,427300260,277300260,11,288029350,2003,184.86684
177,78,2018-03-29,Ready Player One,150000000,137690172,579290136,429290136,3,441599964,2018,286.193424
178,79,2005-11-04,Chicken Little,150000000,135386665,310043823,160043823,11,174657158,2005,106.695882
179,80,2006-05-05,Mission: Impossible III,150000000,133501348,397501348,247501348,5,264000000,2006,165.00089866666667
180,81,2009-05-15,Angels & Demons,150000000,133375846,490875846,340875846,5,357500000,2009,227.250564
181,82,2004-05-14,Troy,150000000,133298577,484161265,334161265,5,350862688,2004,222.77417666666665
182,83,2010-07-01,The Last Airbender,150000000,131772187,319713881,169713881,7,187941694,2010,113.14258733333334
183,84,2007-11-02,Bee Movie,150000000,126631277,287594577,137594577,11,160963300,2007,91.729718
184,85,2009-07-24,G-Force,150000000,119436770,292817841,142817841,7,173381071,2009,95.211894
185,86,2008-11-21,Bolt,150000000,114053579,328015029,178015029,11,213961450,2008,118.676686
186,87,2012-03-30,Wrath of the Titans,150000000,83670083,305270083,155270083,3,221600000,2012,103.51338866666666
187,88,2007-11-16,Beowulf,150000000,82280579,195080579,45080579,11,112800000,2007,30.053719333333333
188,89,2012-05-11,Dark Shadows,150000000,79727149,238202668,88202668,5,158475519,2012,58.80177866666667
189,90,2013-06-28,White House Down,150000000,73103784,205440387,55440387,6,132336603,2013,36.960258
190,91,2010-02-12,The Wolfman,150000000,62189884,142634358,-7365642,2,80444474,2010,-4.910428
191,92,2017-02-17,The Great Wall,150000000,45157105,334486852,184486852,2,289329747,2017,122.99123466666666
192,93,2015-10-09,Pan,150000000,35088320,151525973,1525973,10,116437653,2015,1.0173153333333333
193,94,2011-03-11,Mars Needs Moms,150000000,21392758,39549758,-110450242,3,18157000,2011,-73.63349466666666
194,95,2020-12-31,Moonfall,150000000,0,0,-150000000,12,0,2020,-100.0
195,96,2006-11-03,Flushed Away,149000000,64665672,179357126,30357126,11,114691454,2006,20.373910067114092
196,97,2012-06-08,Madagascar 3: Europe's Most Wanted,145000000,216391482,746921271,601921271,6,530529789,2012,415.1181179310345
197,98,2011-12-16,Mission: ImpossibleâGhost Protocol,145000000,209397903,694713230,549713230,12,485315327,2011,379.1125724137931
198,99,2014-06-13,How to Train Your Dragon 2,145000000,177002924,614586270,469586270,6,437583346,2014,323.8526
199,100,1999-06-16,Tarzan,145000000,171091819,448191819,303191819,6,277100000,1999,209.09780620689654
200,1,2014-03-07,Mr. Peabody & Sherman,145000000,111506430,269806430,124806430,3,158300000,2014,86.0734
201,2,2012-11-21,Rise of the Guardians,145000000,103412758,306900902,161900902,11,203488144,2012,111.65579448275862
202,3,2005-04-08,Sahara,145000000,68671925,121671925,-23328075,4,53000000,2005,-16.088327586206898
203,4,2016-07-15,Ghostbusters,144000000,128350574,229008658,85008658,7,100658084,2016,59.033790277777776
204,5,2002-11-22,Die Another Day,142000000,160942139,431942139,289942139,11,271000000,2002,204.18460492957746
205,6,2003-07-09,Pirates of the Caribbean: The Curse of the Black Pearl,140000000,305411224,634954103,494954103,7,329542879,2003,353.538645
206,7,2009-05-08,Star Trek,140000000,257730019,386839614,246839614,5,129109595,2009,176.31401
207,8,1998-07-01,Armageddon,140000000,201578182,554600000,414600000,7,353021818,1998,296.1428571428571
208,9,2002-07-03,Men in Black 2,140000000,190418803,441767803,301767803,7,251349000,2002,215.54843071428573
209,10,2011-07-22,Captain America: The First Avenger,140000000,176654505,370569776,230569776,7,193915271,2011,164.69269714285716
210,11,2016-01-29,Kung Fu Panda 3,140000000,143528619,517599142,377599142,1,374070523,2016,269.71367285714285
211,12,1998-07-10,Lethal Weapon 4,140000000,130444603,285400000,145400000,7,154955397,1998,103.85714285714285
212,13,2013-03-27,G.I. Joe: Retaliation,140000000,122523060,375740705,235740705,3,253217645,2013,168.38621785714284
213,14,2003-12-05,The Last Samurai,140000000,111110575,456810575,316810575,12,345700000,2003,226.29326785714287
214,15,2005-12-21,Fun With Dick And Jane,140000000,110550000,203018919,63018919,12,92468919,2005,45.01351357142857
215,16,2014-12-12,Exodus: Gods and Kings,140000000,65014513,268314513,128314513,12,203300000,2014,91.65322357142857
216,17,2016-07-01,The BFG,140000000,55483770,199646680,59646680,7,144162910,2016,42.60477142857143
217,18,2016-02-26,Gods of Egypt,140000000,31153464,138836756,-1163244,2,107683292,2016,-0.8308885714285714
218,19,2002-05-03,Spider-Man,139000000,403706375,821706375,682706375,5,418000000,2002,491.1556654676259
219,20,2009-03-06,Watchmen,138000000,107509799,186976250,48976250,3,79466451,2009,35.49003623188406
220,21,2005-07-29,Stealth,138000000,32116746,76416746,-61583254,7,44300000,2005,-44.62554637681159
221,22,2008-06-13,The Incredible Hulk,137500000,134806913,265573859,128073859,6,130766946,2008,93.14462472727273
222,23,2003-06-20,Hulk,137000000,132177234,245075434,108075434,6,112898200,2003,78.88717810218978
223,24,2001-07-11,Final Fantasy: The Spirits Within,137000000,32131830,85131830,-51868170,7,53000000,2001,-37.85997810218978
224,25,2012-11-16,"The Twilight Saga: Breaking Dawn, Part 2",136200000,292324737,829724737,693524737,11,537400000,2012,509.1958421439061
225,26,2013-03-22,The Croods,135000000,187168425,573068425,438068425,3,385900000,2013,324.4951296296296
226,27,2015-12-25,The Revenant,135000000,183637894,532938302,397938302,12,349300408,2015,294.7691125925926
227,28,1999-11-19,The World is Not Enough,135000000,126930660,361730660,226730660,11,234800000,1999,167.94863703703703
228,29,2011-03-04,Rango,135000000,123477607,245724600,110724600,3,122246993,2011,82.01822222222222
229,30,2003-11-14,Master and Commander: The Far Side of the World,135000000,93926386,212912137,77912137,11,118985751,2003,57.71269407407408
230,31,2013-07-17,Turbo,135000000,83028130,286896578,151896578,7,203868448,2013,112.51598370370371
231,32,2016-06-03,Teenage Mutant Ninja Turtles: Out of the Shadows,135000000,82051601,245328374,110328374,6,163276773,2016,81.72472148148148
232,33,2011-11-18,Happy Feet Two,135000000,64006466,157956466,22956466,11,93950000,2011,17.00478962962963
233,34,2006-07-28,Miami Vice,135000000,63478838,163818556,28818556,7,100339718,2006,21.34707851851852
234,35,2018-11-02,The Nutcracker and the Four Realms,132900000,54858851,170293899,37393899,11,115435048,2018,28.1368690744921
235,36,2005-06-29,War of the Worlds,132000000,234280354,606836535,474836535,6,372556181,2005,359.7246477272727
236,37,2014-11-26,Penguins of Madagascar,132000000,83350911,366942531,234942531,11,283591620,2014,177.9867659090909
237,38,2013-11-22,The Hunger Games: Catching Fire,130000000,424668047,864868047,734868047,11,440200000,2013,565.2831130769231
238,39,2004-06-04,Harry Potter and the Prisoner of Azkaban,130000000,249757726,796907323,666907323,6,547149597,2004,513.005633076923
239,40,2007-08-03,The Bourne Ultimatum,130000000,227471070,444043396,314043396,8,216572326,2007,241.5718430769231
240,41,2018-07-06,Ant-Man and the Wasp,130000000,216648740,623144660,493144660,7,406495920,2018,379.3420461538461
241,42,2008-06-06,Kung Fu Panda,130000000,215434591,631910531,501910531,6,416475940,2008,386.0850238461539
242,43,2015-07-17,Ant-Man,130000000,180202163,518858449,388858449,7,338656286,2015,299.1218838461538
243,44,2015-03-27,Home,130000000,177397510,385997896,255997896,3,208600386,2015,196.92145846153846
244,45,2018-12-19,Mary Poppins Returns,130000000,171958438,341528518,211528518,12,169570080,2018,162.71424461538462
245,46,2011-10-28,Puss in Boots,130000000,149260504,554987477,424987477,10,405726973,2011,326.9134438461538
246,47,2010-11-05,Megamind,130000000,148415853,321887208,191887208,11,173471355,2010,147.60554461538462
247,48,2003-07-18,Bad Boys II,130000000,138540870,273271982,143271982,7,134731112,2003,110.20921692307692
248,49,2014-04-11,Rio 2,130000000,131538435,492846291,362846291,4,361307856,2014,279.11253153846155
249,50,2010-07-23,Salt,130000000,118311368,290650494,160650494,7,172339126,2010,123.57730307692307
250,51,2014-03-28,Noah,130000000,101200044,352831065,222831065,3,251631021,2014,171.40851153846154
251,52,2011-12-21,The Adventures of Tintin,130000000,77591831,373993951,243993951,12,296402120,2011,187.68765461538462
252,53,2013-05-31,After Earth,130000000,60522097,251499665,121499665,5,190977568,2013,93.46128076923077
253,54,2008-11-26,Australia,130000000,49554002,215080810,85080810,11,165526808,2008,65.44677692307692
254,55,2013-07-19,R.I.P.D.,130000000,33618855,79076678,-50923322,7,45457823,2013,-39.171786153846156
255,56,2019-02-22,How to Train Your Dragon: The Hidden World,129000000,160791800,519258283,390258283,2,358466483,2019,302.52580077519383
256,57,2011-11-18,"The Twilight Saga: Breaking Dawn, Part 1",127500000,281287133,689420051,561920051,11,408132918,2011,440.721608627451
257,58,2000-05-19,Dinosaur,127500000,137748063,356148063,228648063,5,218400000,2000,179.33181411764704
258,59,2017-03-03,Logan,127000000,226277068,615461394,488461394,3,389184326,2017,384.6152708661417
259,60,2014-12-19,Night at the Museum: Secret of the Tomb,127000000,113746621,353756621,226756621,12,240010000,2014,178.54852047244094
260,61,2011-07-15,Harry Potter and the Deathly Hallows: Part II,125000000,381193157,1341693157,1216693157,7,960500000,2011,973.3545256
261,62,2014-11-21,The Hunger Games: Mockingjay - Part 1,125000000,337135885,766575131,641575131,11,429439246,2014,513.2601048
262,63,2001-11-16,Harry Potter and the Sorcererâs Stone,125000000,317871467,975047606,850047606,11,657176139,2001,680.0380848
263,64,2010-11-19,Harry Potter and the Deathly Hallows: Part I,125000000,296131568,960431568,835431568,11,664300000,2010,668.3452543999999
264,65,2006-05-19,The Da Vinci Code,125000000,217536138,767820459,642820459,5,550284321,2006,514.2563672
265,66,2003-05-02,X-Men 2,125000000,214949694,406875536,281875536,5,191925842,2003,225.50042879999998
266,67,2011-04-29,Fast Five,125000000,210031325,630163454,505163454,4,420132129,2011,404.1307632
267,68,2014-08-08,Teenage Mutant Ninja Turtles,125000000,191204754,485004754,360004754,8,293800000,2014,288.0038032
268,69,2011-12-16,Sherlock Holmes: A Game of Shadows,125000000,186848418,535663443,410663443,12,348815025,2011,328.53075440000003
269,70,2004-05-28,The Day After Tomorrow,125000000,186740799,556319450,431319450,5,369578651,2004,345.05556
270,71,2017-03-31,The Boss Baby,125000000,175003033,510878762,385878762,3,335875729,2017,308.7030096
271,72,2010-04-01,Clash of the Titans,125000000,163214888,493214888,368214888,4,330000000,2010,294.57191040000004
272,73,2016-11-04,Trolls,125000000,153707064,344150134,219150134,11,190443070,2016,175.3201072
273,74,1998-05-19,Godzilla,125000000,136314294,376000000,251000000,5,239685706,1998,200.8
274,75,2012-06-08,Prometheus,125000000,126477084,402448265,277448265,6,275971181,2012,221.95861200000002
275,76,2012-08-10,The Bourne Legacy,125000000,113203870,280355920,155355920,8,167152050,2012,124.28473600000001
276,77,1997-06-20,Batman & Robin,125000000,107325195,238317814,113317814,6,130992619,1997,90.6542512
277,78,2018-07-13,Skyscraper,125000000,68420120,304115534,179115534,7,235695414,2018,143.2924272
278,79,2012-08-03,Total Recall,125000000,58877969,211856088,86856088,8,152978119,2012,69.4848704
279,80,2016-12-21,Assassinâs Creed,125000000,54647948,240759682,115759682,12,186111734,2016,92.6077456
280,81,2017-01-13,Monster Trucks,125000000,33370166,61642798,-63357202,1,28272632,2017,-50.6857616
281,82,1999-08-27,The 13th Warrior,125000000,32698899,61698899,-63301101,8,29000000,1999,-50.6408808
282,83,2000-11-17,How the Grinch Stole Christmas,123000000,260044825,345141403,222141403,11,85096578,2000,180.60276666666667
283,84,2000-05-24,Mission: Impossible 2,120000000,215409889,549588516,429588516,5,334178627,2000,357.99043
284,85,2000-06-30,The Perfect Storm,120000000,182618434,328711434,208711434,6,146093000,2000,173.926195
285,86,2016-07-29,Jason Bourne,120000000,162192920,416168316,296168316,7,253975396,2016,246.80692999999997
286,87,2007-06-15,Fantastic Four: Rise of the Silver Surfer,120000000,131921738,289480691,169480691,6,157558953,2007,141.23390916666668
287,88,2012-11-21,Life of Pi,120000000,124987022,620912003,500912003,11,495924981,2012,417.42666916666667
288,89,2007-02-16,Ghost Rider,120000000,115802596,229545589,109545589,2,113742993,2007,91.28799083333334
289,90,2018-04-13,Rampage,120000000,101028233,428056280,308056280,4,327028047,2018,256.7135666666667
290,91,2003-06-27,Charlie's Angels: Full Throttle,120000000,100814328,227200000,107200000,6,126385672,2003,89.33333333333333
291,92,2013-08-09,Elysium,120000000,93050117,286192091,166192091,8,193141974,2013,138.49340916666665
292,93,2013-04-19,Oblivion,120000000,89107235,287916633,167916633,4,198809398,2013,139.93052749999998
293,94,2017-03-24,Power Rangers,120000000,85364450,142531552,22531552,3,57167102,2017,18.77629333333333
294,95,2002-07-19,Stuart Little 2,120000000,64956806,166000000,46000000,7,101043194,2002,38.333333333333336
295,96,2014-02-12,RoboCop,120000000,58607007,242981799,122981799,2,184374792,2014,102.4848325
296,97,2004-06-11,The Chronicles of Riddick,120000000,57712751,107212751,-12787249,6,49500000,2004,-10.656040833333332
297,98,2015-08-07,Fantastic Four,120000000,56117548,167849187,47849187,8,111731639,2015,39.8743225
298,99,2008-05-09,Speed Racer,120000000,43945766,93394462,-26605538,5,49448696,2008,-22.17128166666667
299,100,2005-07-22,The Island,120000000,35818913,163018913,43018913,7,127200000,2005,35.84909416666667
300,1,2010-12-17,How Do You Know?,120000000,30212620,49628177,-70371823,12,19415557,2010,-58.643185833333334
301,2,2010-06-23,Knight and Day,117000000,76423035,258751370,141751370,6,182328335,2010,121.1550170940171
302,3,2018-10-05,Venom,116000000,213511408,853628605,737628605,10,640117197,2018,635.8867284482758
303,4,1999-05-19,Star Wars Ep. I: The Phantom Menace,115000000,474544677,1027044677,912044677,5,552500000,1999,793.082327826087
304,5,2005-05-19,Star Wars Ep. III: Revenge of the Sith,115000000,380270577,848998877,733998877,5,468728300,2005,638.2598930434782
305,6,2002-05-16,Star Wars Ep. II: Attack of the Clones,115000000,310676740,656695615,541695615,5,346018875,2002,471.03966521739136
306,7,2001-11-02,"Monsters, Inc.",115000000,289423425,559757719,444757719,11,270334294,2001,386.7458426086956
307,8,2013-07-26,The Wolverine,115000000,132556852,416456852,301456852,7,283900000,2013,262.1363930434783
308,9,1997-02-07,Dante's Peak,115000000,67163857,178200000,63200000,2,111036143,1997,54.95652173913044
309,10,2016-04-22,The Huntsman: Winterâs War,115000000,48003015,165149302,50149302,4,117146287,2016,43.60808869565218
310,11,2002-06-14,Windtalkers,115000000,40914068,77628265,-37371735,6,36714197,2002,-32.497160869565214
311,12,2008-07-04,AstÃ©rix aux Jeux Olympiques,113500000,999811,132999811,19499811,7,132000000,2008,17.18045022026432
312,13,2010-12-25,Gulliver's Travels,112000000,42779261,232017848,120017848,12,189238587,2010,107.15879285714284
313,14,2017-12-15,Ferdinand,111000000,84410380,289847930,178847930,12,205437550,2017,161.12426126126127
314,15,2018-05-18,Deadpool 2,110000000,324591735,786680557,676680557,5,462088822,2018,615.1641427272727
315,16,2013-10-04,Gravity,110000000,274092705,693698673,583698673,10,419605968,2013,530.6351572727273
316,17,2006-12-22,Night at the Museum,110000000,250863268,579446407,469446407,12,328583139,2006,426.76946090909087
317,18,2005-06-10,Mr. and Mrs. Smith,110000000,186336279,486124090,376124090,6,299787811,2005,341.9309909090909
318,19,2015-05-29,San Andreas,110000000,155190832,456258539,346258539,5,301067707,2015,314.78049
319,20,2011-07-29,The Smurfs,110000000,142614158,563749323,453749323,7,421135165,2011,412.4993845454545
320,21,2007-06-27,Live Free or Die Hard,110000000,134529403,382288147,272288147,6,247758744,2007,247.53467909090907
321,22,2015-03-20,The Divergent Series: Insurgent,110000000,130179072,295075882,185075882,3,164896810,2015,168.25080181818183
322,23,2004-12-10,Ocean's Twelve,110000000,125531634,362989076,252989076,12,237457442,2004,229.9900690909091
323,24,1997-12-19,Tomorrow Never Dies,110000000,125304276,339504276,229504276,12,214200000,1997,208.6402509090909
324,25,2000-06-28,The Patriot,110000000,113330342,215300000,105300000,6,101969658,2000,95.72727272727273
325,26,2014-03-07,300: Rise of an Empire,110000000,106580051,330780051,220780051,3,224200000,2014,200.70913727272725
326,27,2004-12-17,The Aviator,110000000,102608827,208370892,98370892,12,105762065,2004,89.42808363636362
327,28,2016-12-21,Passengers,110000000,100014699,302239672,192239672,12,202224973,2016,174.76333818181817
328,29,2011-01-14,The Green Hornet,110000000,98780042,229155503,119155503,1,130375461,2011,108.32318454545455
329,30,2016-09-30,Miss Peregrineâs Home for Peculiar Children,110000000,87242834,295986876,185986876,9,208744042,2016,169.07897818181817
330,31,2011-10-07,Real Steel,110000000,85463309,263880341,153880341,10,178417032,2011,139.8912190909091
331,32,2010-06-11,The A-Team,110000000,77222099,177241171,67241171,6,100019072,2010,61.12833727272727
332,33,2013-07-31,The Smurfs 2,110000000,71017784,348547523,238547523,7,277529739,2013,216.86138454545457
333,34,2016-03-18,The Divergent Series: Allegiant,110000000,66184051,172022517,62022517,3,105838466,2016,56.38410636363636
334,35,2009-06-12,The Taking of Pelham 123,110000000,65452312,152364370,42364370,6,86912058,2009,38.51306363636364
335,36,2013-11-01,Ender's Game,110000000,61737191,127983283,17983283,11,66246092,2013,16.348439090909093
336,37,2004-04-02,Home on the Range,110000000,50026353,76482461,-33517539,4,26456108,2004,-30.47049
337,38,1997-06-13,Speed 2: Cruise Control,110000000,48097081,150468000,40468000,6,102370919,1997,36.78909090909091
338,39,2005-05-06,Kingdom of Heaven,110000000,47398413,218853353,108853353,5,171454940,2005,98.95759363636364
339,40,2017-03-31,Ghost in the Shell,110000000,40563557,167910690,57910690,3,127347133,2017,52.64608181818182
340,41,2004-06-16,Around the World in 80 Days,110000000,24004159,72004159,-37995841,6,48000000,2004,-34.54167363636363
341,42,2019-06-14,Men in Black: International,110000000,3100000,3100000,-106900000,6,0,2019,-97.18181818181819
342,43,2001-12-19,The Lord of the Rings: The Fellowship of the Ring,109000000,315544750,887210985,778210985,12,571666235,2001,713.9550321100917
343,44,2003-11-21,The Cat in the Hat,109000000,101018283,133818283,24818283,11,32800000,2003,22.769066972477063
344,45,2001-12-25,Ali,109000000,58183966,87683966,-21316034,12,29500000,2001,-19.555994495412843
345,46,2015-10-02,The Martian,108000000,228433663,655271443,547271443,10,426837780,2015,506.7328175925926
346,47,2016-11-23,Allied,106000000,40098064,119266661,13266661,11,79168597,2016,12.515717924528303
347,48,2004-07-16,"I, Robot",105000000,144801023,348629585,243629585,7,203828562,2004,232.0281761904762
348,49,1999-12-17,Stuart Little,105000000,140015224,298815224,193815224,12,158800000,1999,184.58592761904762
349,50,2009-11-25,The Princess and the Frog,105000000,104400899,270997378,165997378,11,166596479,2009,158.09274095238095
350,51,2008-03-07,"10,000 B.C.",105000000,94784201,269065678,164065678,3,174281477,2008,156.25302666666667
351,52,2016-07-22,Ice Age: Collision Course,105000000,64063008,402156682,297156682,7,338093674,2016,283.0063638095238
352,53,2001-04-27,Town & Country,105000000,6712451,10364769,-94635231,4,3652318,2001,-90.12879142857143
353,54,2017-09-22,Kingsman: The Golden Circle,104000000,100234838,408803696,304803696,9,308568858,2017,293.0804769230769
354,55,2000-06-09,Gone in 60 Seconds,103300000,101643008,232643008,129343008,6,131000000,2000,125.2110435624395
355,56,2000-05-05,Gladiator,103000000,187683805,457683805,354683805,5,270000000,2000,344.35320873786407
356,57,2013-05-23,The Hangover 3,103000000,112200072,362000072,259000072,5,249800000,2013,251.45638058252428
357,58,2018-03-09,A Wrinkle in Time,103000000,100478608,133401882,30401882,3,32923274,2018,29.516390291262134
358,59,2009-07-01,Public Enemies,102500000,97104620,212282709,109782709,7,115178089,2009,107.1050819512195
359,60,2006-11-17,Casino Royale,102000000,167365000,594420283,492420283,11,427055283,2006,482.7649833333333
360,61,2002-06-21,Minority Report,102000000,132024714,358824714,256824714,6,226800000,2002,251.78893529411766
361,62,2018-12-21,Bumblebee,102000000,127195589,465195589,363195589,12,338000000,2018,356.0741068627451
362,63,2012-10-26,Cloud Atlas,102000000,27108272,130673154,28673154,10,103564882,2012,28.110935294117645
363,64,2002-11-15,Harry Potter and the Chamber of Secrets,100000000,262233381,879225135,779225135,11,616991754,2002,779.225135
364,65,1991-07-02,Terminator 2: Judgment Day,100000000,203464105,515419827,415419827,7,311955722,1991,415.419827
365,66,1995-06-16,Batman Forever,100000000,184031112,336529144,236529144,6,152498032,1995,236.529144
366,67,2001-07-27,Planet of the Apes,100000000,180011740,362211740,262211740,7,182200000,2001,262.21174
367,68,2004-11-19,National Treasure,100000000,173005002,331323410,231323410,11,158318408,2004,231.32341
368,69,2012-12-25,Django Unchained,100000000,162805434,449948323,349948323,12,287142889,2012,349.948323
369,70,2010-12-22,Little Fockers,100000000,148438600,310650574,210650574,12,162211974,2010,210.65057399999998
370,71,1994-07-15,True Lies,100000000,146282411,365300000,265300000,7,219017589,1994,265.3
371,72,2007-11-02,American Gangster,100000000,130164645,267985456,167985456,11,137820811,2007,167.985456
372,73,2009-09-18,Cloudy with a Chance of Meatballs,100000000,124870275,236827677,136827677,9,111957402,2009,136.827677
373,74,2010-08-06,The Other Guys,100000000,119219978,170936470,70936470,8,51716492,2010,70.93647
374,75,2004-12-17,Lemony Snicket's A Series of Unfortunate Events,100000000,118627117,212956024,112956024,12,94328907,2004,112.956024
375,76,2013-12-25,The Wolf of Wall Street,100000000,116900694,389870414,289870414,12,272969720,2013,289.870414
376,77,2013-05-24,Epic,100000000,107518682,262794441,162794441,5,155275759,2013,162.794441
377,78,1996-06-21,Eraser,100000000,101295562,234400000,134400000,6,133104438,1996,134.4
378,79,1996-06-21,The Hunchback of Notre Dame,100000000,100138851,325500000,225500000,6,225361149,1996,225.5
379,80,2000-12-15,The Emperor's New Groove,100000000,89296573,169296573,69296573,12,80000000,2000,69.296573
380,81,2012-08-17,The Expendables 2,100000000,85028192,311979256,211979256,8,226951064,2012,211.979256
381,82,2009-10-16,Where the Wild Things Are,100000000,77233467,99123656,-876344,10,21890189,2009,-0.8763440000000001
382,83,2006-12-15,Eragon,100000000,75030163,249488115,149488115,12,174457952,2006,149.48811500000002
383,84,2014-07-25,Hercules,100000000,72688614,243388614,143388614,7,170700000,2014,143.388614
384,85,2010-12-10,The Tourist,100000000,67631157,278731369,178731369,12,211100212,2010,178.731369
385,86,1999-11-24,End of Days,100000000,66889043,212026975,112026975,11,145137932,1999,112.02697500000001
386,87,2004-06-11,The Stepford Wives,100000000,59475623,96221971,-3778029,6,36746348,2004,-3.778029
387,88,2007-06-08,Surf's Up,100000000,58867694,145395745,45395745,6,86528051,2007,45.395745
388,89,2006-12-08,Blood Diamond,100000000,57377916,171377916,71377916,12,114000000,2006,71.377916
389,90,2010-09-24,Legend of the Guardians: The Owls of Ga'Hoole,100000000,55675313,139716717,39716717,9,84041404,2010,39.716717
390,91,1997-11-07,Starship Troopers,100000000,54768952,121100000,21100000,11,66331048,1997,21.099999999999998
391,92,2009-06-05,Land of the Lost,100000000,49438370,69548641,-30451359,6,20110271,2009,-30.451359
392,93,2003-12-25,Peter Pan,100000000,48417850,95255485,-4744515,12,46837635,2003,-4.744515
393,94,2019-03-15,Wonder Park,100000000,45216793,115149422,15149422,3,69932629,2019,15.149422000000001
394,95,2004-07-23,Catwoman,100000000,40202379,82145379,-17854621,7,41943000,2004,-17.854621
395,96,2014-08-15,The Expendables 3,100000000,39322544,209461378,109461378,8,170138834,2014,109.461378
396,97,2002-11-27,Treasure Planet,100000000,38120554,91800000,-8200000,11,53679446,2002,-8.200000000000001
397,98,2010-03-12,Green Zone,100000000,35497337,97523020,-2476980,3,62025683,2010,-2.47698
398,99,2017-10-20,Geostorm,100000000,33700160,220796009,120796009,10,187095849,2017,120.796009
399,100,2015-12-25,Point Break,100000000,28782481,126704591,26704591,12,97922110,2015,26.704591
400,1,2015-12-11,In the Heart of the Sea,100000000,25020758,89693309,-10306691,12,64672551,2015,-10.306690999999999
401,2,2014-04-18,Transcendence,100000000,23022309,103039258,3039258,4,80016949,2014,3.039258
402,3,2005-02-18,Son of the Mask,100000000,17018422,59918422,-40081578,2,42900000,2005,-40.081578
403,4,2018-12-14,Mortal Engines,100000000,15951040,85287417,-14712583,12,69336377,2018,-14.712583000000002
404,5,2002-08-16,The Adventures of Pluto Nash,100000000,4411102,7094995,-92905005,8,2683893,2002,-92.905005
405,6,2012-01-20,Jin lÃ­ng shÃ­ san chai,100000000,311434,98227017,-1772983,1,97915583,2012,-1.7729829999999998
406,7,2015-11-06,The Peanuts Movie,99000000,130178411,250091610,151091610,11,119913199,2015,152.61778787878788
407,8,2019-02-08,The LEGO Movie 2: The Second Part,99000000,105806508,190325698,91325698,2,84519190,2019,92.2481797979798
408,9,2018-11-21,Robin Hood,99000000,30824628,84747441,-14252559,11,53922813,2018,-14.396524242424242
409,10,2001-05-04,The Mummy Returns,98000000,202007640,435040395,337040395,5,233032755,2001,343.91877040816325
410,11,2002-12-20,Gangs of New York,97000000,77730500,183124621,86124621,12,105394121,2002,88.78826907216495
411,12,2017-05-19,Alien: Covenant,97000000,74262031,238521247,141521247,5,164259216,2017,145.89819278350515
412,13,2015-03-13,Cinderella,95000000,201151353,534551353,439551353,3,333400000,2015,462.68563473684213
413,14,2012-07-13,Ice Age: Continental Drift,95000000,161321843,879765137,784765137,7,718443294,2012,826.068565263158
414,15,2001-12-28,Black Hawk Down,95000000,108638745,159691085,64691085,12,51052340,2001,68.09587894736842
415,16,2010-05-27,Sex and the City 2,95000000,95347692,294680778,199680778,5,199333086,2010,210.19029263157893
416,17,2010-02-12,Percy Jackson & the Olympians: The Lightning Thief,95000000,88768303,223050874,128050874,2,134282571,2010,134.79039368421053
417,18,2012-08-10,The Campaign,95000000,86907746,104907746,9907746,8,18000000,2012,10.429206315789475
418,19,2010-11-12,Unstoppable,95000000,81562942,165720921,70720921,11,84157979,2010,74.4430747368421
419,20,1997-05-09,The Fifth Element,95000000,63570862,263898761,168898761,5,200327899,1997,177.7881694736842
420,21,2000-03-31,The Road to El Dorado,95000000,50802661,65700000,-29300000,3,14897339,2000,-30.842105263157894
421,22,2009-12-11,The Lovely Bones,95000000,44114232,94894448,-105552,12,50780216,2009,-0.11110736842105264
422,23,2016-08-19,Ben-Hur,95000000,26410477,91669648,-3330352,8,65259171,2016,-3.505633684210526
423,24,2015-02-06,Seventh Son,95000000,17725785,108874967,13874967,2,91149182,2015,14.605228421052633
424,25,2003-05-30,Finding Nemo,94000000,380529370,936429370,842429370,5,555900000,2003,896.2014574468085
425,26,2003-12-17,The Lord of the Rings: The Return of the King,94000000,377845905,1141403341,1047403341,12,763557436,2003,1114.2588734042554
426,27,2002-12-18,The Lord of the Rings: The Two Towers,94000000,342548984,934699645,840699645,12,592150661,2002,894.3613244680851
427,28,2001-06-15,Lara Croft: Tomb Raider,94000000,131144183,273330185,179330185,6,142186002,2001,190.77679255319148
428,29,2015-02-13,Kingsman: The Secret Service,94000000,128261724,404561724,310561724,2,276300000,2015,330.38481276595746
429,30,2001-07-18,Jurassic Park III,93000000,181166115,365900000,272900000,7,184733885,2001,293.44086021505376
430,31,2011-08-05,Rise of the Planet of the Apes,93000000,176760185,470986200,377986200,8,294226015,2011,406.43677419354833
431,32,2008-02-14,The Spiderwick Chronicles,92500000,71195053,162839667,70339667,2,91644614,2008,76.04288324324324
432,33,2004-11-05,The Incredibles,92000000,261441092,614726752,522726752,11,353285660,2004,568.1812521739131
433,34,2013-02-14,A Good Day to Die Hard,92000000,67349198,304249198,212249198,2,236900000,2013,230.70565
434,35,2004-04-09,The Alamo,92000000,22406362,23911362,-68088638,4,1505000,2004,-74.00938913043478
435,36,1995-12-22,Cutthroat Island,92000000,10017322,18517322,-73482678,12,8500000,1995,-79.87247608695652
436,37,2013-12-25,The Secret Life of Walter Mitty,91000000,58236838,187861183,96861183,12,129624345,2013,106.44086043956045
437,38,2017-12-20,Jumanji: Welcome to the Jungle,90000000,404508916,964496193,874496193,12,559987277,2017,971.6624366666666
438,39,1997-07-01,Men in Black,90000000,250690539,587790539,497790539,7,337100000,1997,553.1005988888888
439,40,1999-11-19,Toy Story 2,90000000,245852179,511358276,421358276,11,265506097,1999,468.17586222222224
440,41,2001-08-03,Rush Hour 2,90000000,226164286,347425832,257425832,8,121261546,2001,286.02870222222225
441,42,2009-12-25,Sherlock Holmes,90000000,209028679,498438212,408438212,12,289409533,2009,453.8202355555556
442,43,2009-07-01,Ice Age: Dawn of the Dinosaurs,90000000,196573705,859701857,769701857,7,663128152,2009,855.2242855555555
443,44,2018-12-14,Spider-Man: Into The Spider-Verse 3D,90000000,190173195,375381768,285381768,12,185208573,2018,317.0908533333333
444,45,2000-07-21,What Lies Beneath,90000000,155464351,288693989,198693989,7,133229638,2000,220.7710988888889
445,46,2011-04-15,Rio,90000000,143619809,487519809,397519809,4,343900000,2011,441.6886766666667
446,47,2006-10-06,The Departed,90000000,132384315,289660619,199660619,10,157276304,2006,221.84513222222222
447,48,2000-11-03,Charlie's Angels,90000000,125305545,259736090,169736090,11,134430545,2000,188.59565555555554
448,49,1998-06-19,Mulan,90000000,120620254,303500000,213500000,6,182879746,1998,237.22222222222223
449,50,2008-08-13,Tropic Thunder,90000000,110515313,191145256,101145256,8,80629943,2008,112.38361777777777
450,51,2011-12-20,The Girl with the Dragon Tattoo,90000000,102515793,239373970,149373970,12,136858177,2011,165.97107777777777
451,52,1997-07-11,Contact,90000000,100920329,165900000,75900000,7,64979671,1997,84.33333333333334
452,53,2008-06-06,You Don't Mess With the Zohan,90000000,100018837,202910991,112910991,6,102892154,2008,125.45665666666667
453,54,1995-05-19,Die Hard: With a Vengeance,90000000,100012499,366101666,276101666,5,266089167,1995,306.77962888888885
454,55,2016-09-23,The Magnificent Seven,90000000,93432655,162525156,72525156,9,69092501,2016,80.58350666666666
455,56,2015-12-18,Alvin and the Chipmunks: The Road Chip,90000000,85886987,249517956,159517956,12,163630969,2015,177.24217333333334
456,57,2001-06-08,Atlantis: The Lost Empire,90000000,84052762,186049020,96049020,6,101996258,2001,106.72113333333333
457,58,2008-12-25,Valkyrie,90000000,83107829,203932174,113932174,12,120824345,2008,126.59130444444445
458,59,2015-07-24,Pixels,90000000,78765986,244041804,154041804,7,165275818,2015,171.15756
459,60,2001-06-29,Artificial Intelligence: AI,90000000,78616689,235900000,145900000,6,157283311,2001,162.11111111111111
460,61,2003-11-26,The Haunted Mansion,90000000,75817994,155750628,65750628,11,79932634,2003,73.05625333333333
461,62,2000-08-04,Hollow Man,90000000,73209340,191200000,101200000,8,117990660,2000,112.44444444444443
462,63,2005-04-22,The Interpreter,90000000,72708161,162753837,72753837,4,90045676,2005,80.83759666666667
463,64,2013-08-07,Percy Jackson: Sea of Monsters,90000000,68559554,200859554,110859554,8,132300000,2013,123.17728222222222
464,65,2003-07-25,Lara Croft: Tomb Raider: The Cradle of Life,90000000,65653758,157092943,67092943,7,91439185,2003,74.54771444444445
465,66,2016-06-10,Now You See Me 2,90000000,65075540,328325007,238325007,6,263249467,2016,264.80556333333334
466,67,2001-11-21,Spy Game,90000000,62362560,143049560,53049560,11,80687000,2001,58.94395555555556
467,68,1997-04-04,The Saint,90000000,61363304,169400000,79400000,4,108036696,1997,88.22222222222223
468,69,2000-03-10,Mission to Mars,90000000,60874615,106000000,16000000,3,45125385,2000,17.77777777777778
469,70,2018-03-16,Tomb Raider,90000000,58250803,273477501,183477501,3,215226698,2018,203.86389
470,71,1999-12-17,Bicentennial Man,90000000,58220776,87420776,-2579224,12,29200000,1999,-2.865804444444444
471,72,2004-07-07,King Arthur,90000000,51877963,203877963,113877963,7,152000000,2004,126.53106999999999
472,73,1997-04-25,Volcano,90000000,47546796,120100000,30100000,4,72553204,1997,33.44444444444444
473,74,1997-03-26,The Devil's Own,90000000,42885593,140900000,50900000,3,98014407,1997,56.55555555555556
474,75,2002-07-19,K-19: The Widowmaker,90000000,35168966,65716126,-24283874,7,30547160,2002,-26.98208222222222
475,76,2011-08-19,Conan the Barbarian,90000000,21295021,63356133,-26643867,8,42061112,2011,-29.60429666666667
476,77,2011-10-21,The Three Musketeers,90000000,20377913,139877913,49877913,10,119500000,2011,55.41990333333333
477,78,2017-04-21,The Promise,90000000,8224288,10551417,-79448583,4,2327129,2017,-88.27620333333334
478,79,2010-11-24,The Nutcracker in 3D,90000000,195459,20466016,-69533984,11,20270557,2010,-77.25998222222222
479,80,2017-12-13,Bright,90000000,0,0,-90000000,12,0,2017,-100.0
480,81,2019-12-31,Army of the Dead,90000000,0,0,-90000000,12,0,2019,-100.0
481,82,1996-05-10,Twister,88000000,241688385,495700000,407700000,5,254011615,1996,463.2954545454545
482,83,2005-06-03,Cinderella Man,88000000,61649911,105021488,17021488,6,43371577,2005,19.342599999999997
483,84,2018-09-14,The Predator,88000000,51024708,159487563,71487563,9,108462855,2018,81.23586704545454
484,85,2005-07-08,Fantastic Four,87500000,154696080,333132750,245632750,7,178436670,2005,280.7231428571428
485,86,2001-02-09,Hannibal,87000000,165092266,350100280,263100280,2,185008014,2001,302.4141149425287
486,87,2003-07-25,Seabiscuit,86000000,120277854,148715342,62715342,7,28437488,2003,72.92481627906977
487,88,2000-12-22,Cast Away,85000000,233632142,427230516,342230516,12,193598374,2000,402.6241364705882
488,89,2006-11-17,Happy Feet,85000000,198000317,385000317,300000317,11,187000000,2006,352.9415494117647
489,90,2001-12-07,Ocean's Eleven,85000000,183417150,450728529,365728529,12,267311379,2001,430.26885764705884
490,91,2004-07-23,The Bourne Supremacy,85000000,176087450,311001124,226001124,7,134913674,2004,265.88367529411767
491,92,1997-07-25,Air Force One,85000000,172956409,315268353,230268353,7,142311944,1997,270.90394470588234
492,93,2009-04-03,Fast & Furious,85000000,155064265,363064265,278064265,4,208000000,2009,327.1344294117647
493,94,2008-03-14,Horton Hears a Who,85000000,154529439,299477886,214477886,3,144948447,2008,252.32692470588236
494,95,2014-03-21,Divergent,85000000,150947895,276014965,191014965,3,125067070,2014,224.7234882352941
495,96,2012-09-28,Hotel Transylvania,85000000,148313048,378505812,293505812,9,230192764,2012,345.30095529411767
496,97,2019-04-05,Shazam!,85000000,139606856,362899733,277899733,4,223292877,2019,326.9408623529412
497,98,2007-11-21,Enchanted,85000000,127706877,340384141,255384141,11,212677264,2007,300.4519305882353
498,99,2012-02-10,Safe House,85000000,126181630,208542162,123542162,2,82360532,2012,145.34372
499,100,2007-07-20,I Now Pronounce You Chuck and Larry,85000000,119725280,185708462,100708462,7,65983182,2007,118.48054352941178
500,1,2007-06-08,Ocean's Thirteen,85000000,117144465,311744465,226744465,6,194600000,2007,266.75819411764707
501,2,2009-12-25,Itâs Complicated,85000000,112735375,224614744,139614744,12,111879369,2009,164.25263999999999
502,3,1998-11-20,Enemy of the State,85000000,111549836,250649836,165649836,11,139100000,1998,194.88216
503,4,2006-09-29,Open Season,85000000,85105259,191932158,106932158,9,106826899,2006,125.8025388235294
504,5,2011-11-04,Tower Heist,85000000,78046570,150422946,65422946,11,72376376,2011,76.96817176470589
505,6,2000-11-22,102 Dalmatians,85000000,66941559,66941559,-18058441,11,0,2000,-21.245224705882354
506,7,2012-03-30,Mirror Mirror,85000000,64935167,173613482,88613482,3,108678315,2012,104.25115529411764
507,8,2006-12-08,The Holiday,85000000,63280000,205190324,120190324,12,141910324,2006,141.40038117647057
508,9,2006-06-16,The Fast and the Furious: Tokyo Drift,85000000,62615510,157794205,72794205,6,95178695,2006,85.64024117647058
509,10,2005-12-09,Memoirs of a Geisha,85000000,57010853,161510853,76510853,12,104500000,2005,90.01276823529412
510,11,2001-03-16,Enemy at the Gates,85000000,51396781,96971293,11971293,3,45574512,2001,14.083874117647058
511,12,1993-06-18,Last Action Hero,85000000,50016394,137298489,52298489,6,87282095,1993,61.527634117647054
512,13,2003-09-26,The Rundown,85000000,47641743,80831893,-4168107,9,33190150,2003,-4.903655294117646
513,14,2011-11-23,Arthur Christmas,85000000,46462469,149717124,64717124,11,103254655,2011,76.13779294117647
514,15,2017-01-20,xXx: Return of Xander Cage,85000000,44898413,345033359,260033359,1,300134946,2017,305.9215988235294
515,16,1998-11-13,Meet Joe Black,85000000,44650003,44650003,-40349997,11,0,1998,-47.47058470588235
516,17,2010-07-30,Cats & Dogs: The Revenge of Kitty Galore,85000000,43585753,113026383,28026383,7,69440630,2010,32.972215294117646
517,18,2002-02-08,Collateral Damage,85000000,40048332,78353508,-6646492,2,38305176,2002,-7.819402352941177
518,19,2002-03-15,Showtime,85000000,37948765,78948765,-6051235,3,41000000,2002,-7.1191
519,20,1995-06-30,Judge Dredd,85000000,34687912,113487912,28487912,6,78800000,1995,33.51519058823529
520,21,2007-03-02,Zodiac,85000000,33080084,83080084,-1919916,3,50000000,2007,-2.258724705882353
521,22,2010-08-13,Scott Pilgrim vs. The World,85000000,31611316,48056764,-36943236,8,16445448,2010,-43.4626305882353
522,23,2003-03-28,The Core,85000000,31111260,74132631,-10867369,3,43021371,2003,-12.78514
523,24,1997-05-09,Father's Day,85000000,28681080,35681080,-49318920,5,7000000,1997,-58.02225882352941
524,25,2017-12-20,The Greatest Showman,84000000,174340174,386665550,302665550,12,212325376,2017,360.31613095238095
525,26,2002-06-14,Scooby-Doo,84000000,153294164,276294164,192294164,6,123000000,2002,228.9216238095238
526,27,2000-07-28,Nutty Professor II: The Klumps,84000000,123307945,166307945,82307945,7,43000000,2000,97.98564880952381
527,28,2013-07-19,RED 2,84000000,53262560,141507355,57507355,7,88244795,2013,68.46113690476191
528,29,2006-06-23,Click,82500000,137355633,237685089,155185089,6,100329456,2006,188.1031381818182
529,30,2006-12-15,Charlotte's Web,82500000,82985708,143985708,61485708,12,61000000,2006,74.5281309090909
530,31,2008-02-14,Jumper,82500000,80172128,222640812,140140812,2,142468684,2008,169.8676509090909
531,32,2008-07-11,Hellboy II: The Golden Army,82500000,75986503,160388063,77888063,7,84401560,2008,94.40977333333333
532,33,2005-05-27,The Longest Yard,82000000,158119460,191558505,109558505,5,33439045,2005,133.60793292682928
533,34,2010-08-13,The Expendables,82000000,103068524,268268174,186268174,8,165199650,2010,227.15630975609758
534,35,2000-11-17,The 6th Day,82000000,34543701,96024898,14024898,11,61481197,2000,17.103534146341463
535,36,2020-02-21,Call of the Wild,82000000,0,0,-82000000,2,0,2020,-100.0
536,37,2003-05-23,Bruce Almighty,81000000,242704995,484468608,403468608,5,241763613,2003,498.1093925925926
537,38,2012-03-23,The Hunger Games,80000000,408010692,677923379,597923379,3,269912687,2012,747.40422375
538,39,2011-05-26,The Hangover Part II,80000000,254464305,586464305,506464305,5,332000000,2011,633.08038125
539,40,1996-05-21,Mission: Impossible,80000000,180981886,457697994,377697994,5,276716108,1996,472.12249249999996
540,41,2017-02-10,The Lego Batman Movie,80000000,175750384,310660018,230660018,2,134909634,2017,288.3250225
541,42,2015-09-25,Hotel Transylvania 2,80000000,169700110,469500298,389500298,9,299800188,2015,486.8753725
542,43,1992-06-18,Batman Returns,80000000,162833635,266824291,186824291,6,103990656,1992,233.53036375
543,44,1999-05-07,The Mummy,80000000,155385488,416385488,336385488,5,261000000,1999,420.48186000000004
544,45,2006-05-19,Over the Hedge,80000000,155019340,343397247,263397247,5,188377907,2006,329.24655875
545,46,2002-06-21,Lilo & Stitch,80000000,145771527,245800000,165800000,6,100028473,2002,207.24999999999997
546,47,1998-05-08,Deep Impact,80000000,140464664,349464664,269464664,5,209000000,1998,336.83083
547,48,2013-07-12,Grown Ups 2,80000000,133668525,247023808,167023808,7,113355283,2013,208.77976
548,49,2011-12-16,Alvin and the Chipmunks: Chipwrecked,80000000,133107389,349088523,269088523,12,215981134,2011,336.36065375
549,50,2008-06-20,Get Smart,80000000,130319208,226739416,146739416,6,96420208,2008,183.42426999999998
550,51,2005-03-11,Robots,80000000,128200012,260700012,180700012,3,132500000,2005,225.875015
551,52,2010-02-19,Shutter Island,80000000,128012934,299461782,219461782,2,171448848,2010,274.3272275
552,53,2003-12-12,Something's Gotta Give,80000000,124685242,266685242,186685242,12,142000000,2003,233.3565525
553,54,2008-11-26,Four Christmases,80000000,120146040,168311558,88311558,11,48165518,2008,110.38944749999999
554,55,1997-06-27,Face/Off,80000000,112276146,241200000,161200000,6,128923854,1997,201.5
555,56,2008-12-25,Bedtime Stories,80000000,110101975,221468935,141468935,12,111366960,2008,176.83616874999998
556,57,2002-07-12,Road to Perdition,80000000,104054514,183354514,103354514,7,79300000,2002,129.1931425
557,58,2011-02-11,Just Go With It,80000000,103028109,214974953,134974953,2,111946844,2011,168.71869125
558,59,2003-02-14,Daredevil,80000000,102543518,182782518,102782518,2,80239000,2003,128.4781475
559,60,2008-09-26,Eagle Eye,80000000,101440743,180585259,100585259,9,79144516,2008,125.73157375
560,61,1997-06-06,Con Air,80000000,101117573,224117573,144117573,6,123000000,1997,180.14696625
561,62,2010-12-17,Yogi Bear,80000000,100246011,204774690,124774690,12,104528679,2010,155.96836249999998
562,63,2003-12-25,Cold Mountain,80000000,95632614,165173909,85173909,12,69541295,2003,106.46738625
563,64,2010-01-15,The Book of Eli,80000000,94835059,158750817,78750817,1,63915758,2010,98.43852125
564,65,1997-11-26,Flubber,80000000,92993801,177993801,97993801,11,85000000,1997,122.49225125000001
565,66,1999-07-23,The Haunting,80000000,91188905,180188905,100188905,7,89000000,1999,125.23613125
566,67,1996-11-15,Space Jam,80000000,90463534,250200000,170200000,11,159736466,1996,212.75
567,68,2014-10-17,Fury,80000000,85817906,210315681,130315681,10,124497775,2014,162.89460125
568,69,2018-09-28,Smallfoot,80000000,83240103,213691277,133691277,9,130451174,2018,167.11409625
569,70,2006-02-10,The Pink Panther,80000000,82226474,158926474,78926474,2,76700000,2006,98.65809250000001
570,71,2011-07-08,Zookeeper,80000000,80360866,170805525,90805525,7,90444659,2011,113.50690625
571,72,2008-12-12,The Day the Earth Stood Still,80000000,79366978,237370350,157370350,12,158003372,2008,196.7129375
572,73,1997-08-08,Conspiracy Theory,80000000,76118990,142783718,62783718,8,66664728,1997,78.4796475
573,74,1998-06-12,"Six Days, Seven Nights",80000000,74339294,164800000,84800000,6,90460706,1998,106.0
574,75,2002-05-24,Spirit: Stallion of the Cimarron,80000000,73215310,106515310,26515310,5,33300000,2002,33.1441375
575,76,2001-06-08,Swordfish,80000000,69772969,147080413,67080413,6,77307444,2001,83.85051625
576,77,1999-12-31,Fantasia 2000 (Theatrical Release),80000000,69610858,69618634,-10381366,12,7776,1999,-12.976707500000002
577,78,1998-04-03,Lost In Space,80000000,69117629,136047317,56047317,4,66929688,1998,70.05914625
578,79,2004-07-30,The Manchurian Candidate,80000000,65948711,96148711,16148711,7,30200000,2004,20.18588875
579,80,2006-11-22,DÃ©jÃ Vu,80000000,64038616,181038616,101038616,11,117000000,2006,126.29827
580,81,2019-06-07,The Secret Life of Pets 2,80000000,63795655,113351496,33351496,6,49555841,2019,41.68937
581,82,2005-06-24,Bewitched,80000000,63313159,131159306,51159306,6,67846147,2005,63.949132500000005
582,83,2002-03-08,The Time Machine,80000000,56684819,98983590,18983590,3,42298771,2002,23.729487499999998
583,84,1998-10-02,What Dreams May Come,80000000,55485043,71485043,-8514957,10,16000000,1998,-10.64369625
584,85,1998-12-25,Mighty Joe Young,80000000,50632037,50632037,-29367963,12,0,1998,-36.709953750000004
585,86,2005-10-28,The Legend of Zorro,80000000,45575336,141475336,61475336,10,95900000,2005,76.84417
586,87,2000-11-10,Little Nicky,80000000,39442871,58270391,-21729609,11,18827520,2000,-27.162011250000003
587,88,2009-09-25,Surrogates,80000000,38577772,119668350,39668350,9,81090578,2009,49.585437500000005
588,89,2001-06-08,Evolution,80000000,38311134,98341932,18341932,6,60030798,2001,22.927415
589,90,2005-08-26,The Brothers Grimm,80000000,37899638,105299638,25299638,8,67400000,2005,31.6245475
590,91,1996-12-13,Mars Attacks!,80000000,37771017,101371017,21371017,12,63600000,1996,26.71377125
591,92,2006-04-14,The Wild,80000000,37384046,99010667,19010667,4,61626621,2006,23.76333375
592,93,2013-12-20,Walking with Dinosaurs,80000000,36076121,123368842,43368842,12,87292721,2013,54.2110525
593,94,2000-12-22,Thirteen Days,80000000,34566746,66554547,-13445453,12,31987801,2000,-16.80681625
594,95,1996-12-06,Daylight,80000000,32908290,158908290,78908290,12,126000000,1996,98.6353625
595,96,2015-10-23,The Last Witch Hunter,80000000,27367660,130818912,50818912,10,103451252,2015,63.52364
596,97,2014-02-21,Pompeii,80000000,23169033,108469033,28469033,2,85300000,2014,35.58629125
597,98,2000-05-12,Battlefield Earth: A Saga of the Year 3000,80000000,21471685,29725663,-50274337,5,8253978,2000,-62.842921249999996
598,99,2003-11-14,Looney Tunes: Back in Action,80000000,20950820,54540662,-25459338,11,33589842,2003,-31.824172499999996
599,100,2009-12-18,Nine,80000000,19676965,53508858,-26491142,12,33831893,2009,-33.1139275
600,1,2003-11-26,Timeline,80000000,19480739,26703184,-53296816,11,7222445,2003,-66.62102
601,2,2010-04-22,Oceans,80000000,19422319,86787530,6787530,4,67365211,2010,8.484412500000001
602,3,1998-11-25,Babe: Pig in the City,80000000,18319860,69131860,-10868140,11,50812000,1998,-13.585175
603,4,1997-12-25,The Postman,80000000,17650704,20841123,-59158877,12,3190419,1997,-73.94859625
604,5,2000-11-10,Red Planet,80000000,17480890,33463969,-46536031,11,15983079,2000,-58.170038749999996
605,6,2007-01-12,Arthur et les Minimoys,80000000,15132763,113325743,33325743,1,98192980,2007,41.65717875
606,7,2007-08-17,The Invasion,80000000,15074191,40147042,-39852958,8,25072851,2007,-49.8161975
607,8,2005-09-02,A Sound of Thunder,80000000,1900451,6300451,-73699549,9,4400000,2005,-92.12443625
608,9,1994-06-15,The Lion King,79300000,421785283,986214868,906914868,6,564429585,1994,1143.6505271122319
609,10,2012-02-10,Journey 2: The Mysterious Island,79000000,103860290,318146162,239146162,2,214285872,2012,302.71666075949366
610,11,2011-11-11,Jack and Jill,79000000,74158157,150519217,71519217,11,76361060,2011,90.53065443037974
611,12,2001-12-21,A Beautiful Mind,78000000,170708996,317668058,239668058,12,146959062,2001,307.266741025641
612,13,2013-09-27,Cloudy with a Chance of Meatballs 2,78000000,119793567,274392649,196392649,9,154599082,2013,251.78544743589742
613,14,2002-10-04,Red Dragon,78000000,92955420,206455420,128455420,10,113500000,2002,164.6864358974359
614,15,2004-03-05,Hidalgo,78000000,67286731,108086731,30086731,3,40800000,2004,38.57273205128205
615,16,2003-07-11,The League of Extraordinary Gentlemen,78000000,66465204,179265204,101265204,7,112800000,2003,129.8271846153846
616,17,2004-08-20,Exorcist: The Beginning,78000000,41814863,43957541,-34042459,8,2142678,2004,-43.644178205128206
617,18,2012-12-31,AstÃ©rix et ObÃ©lix: Au service de Sa MajestÃ©,77600000,0,60680125,-16919875,12,60680125,2012,-21.803962628865982
618,19,2016-02-12,The Little Prince,77500000,1311213,102028919,24528919,2,100717706,2016,31.650218064516128
619,20,2019-01-22,Renegades,77500000,0,1521672,-75978328,1,1521672,2019,-98.03655225806452
620,21,2018-07-20,The Equalizer 2,77000000,102084362,190453132,113453132,7,88368770,2018,147.34172987012988
621,22,2013-07-03,Despicable Me 2,76000000,368065385,975216835,899216835,7,607151450,2013,1183.1800460526315
622,23,2003-06-06,2 Fast 2 Furious,76000000,127120058,236410607,160410607,6,109290549,2003,211.06658815789473
623,24,2006-12-25,Children of Men,76000000,35552383,69845011,-6154989,12,34292628,2006,-8.098669736842105
624,25,2000-06-30,The Adventures of Rocky & Bullwinkle,76000000,26000610,35129610,-40870390,6,9129000,2000,-53.776828947368415
625,26,2016-07-08,The Secret Life of Pets,75000000,368384330,886750534,811750534,7,518366204,2016,1082.3340453333333
626,27,1996-07-02,Independence Day,75000000,306169255,817400878,742400878,7,511231623,1996,989.8678373333332
627,28,2018-11-09,Dr. Seussâ The Grinch,75000000,270620950,511002426,436002426,11,240381476,2018,581.336568
628,29,2016-12-21,Sing,75000000,270329045,634454789,559454789,12,364125744,2016,745.9397186666667
629,30,2017-06-30,Despicable Me 3,75000000,264624300,1034727750,959727750,6,770103450,2017,1279.637
630,31,1997-05-22,The Lost World: Jurassic Park,75000000,229086679,618638999,543638999,5,389552320,1997,724.8519986666666
631,32,2006-03-31,Ice Age: The Meltdown,75000000,195330621,651899282,576899282,3,456568661,2006,769.1990426666667
632,33,2005-05-27,Madagascar,75000000,193595521,556559566,481559566,5,362964045,2005,642.0794213333334
633,34,2010-06-25,Grown Ups,75000000,162001186,272223430,197223430,6,110222244,2010,262.9645733333333
634,35,2004-10-01,Shark Tale,75000000,161412000,371917043,296917043,10,210505043,2004,395.8893906666667
635,36,2000-07-14,X-Men,75000000,157299717,296872367,221872367,7,139572650,2000,295.8298226666667
636,37,2008-06-27,Wanted,75000000,134508551,342416460,267416460,6,207907909,2008,356.55528
637,38,1996-06-07,The Rock,75000000,134069511,336069511,261069511,6,202000000,1996,348.0926813333333
638,39,2004-02-13,50 First Dates,75000000,120776832,196320329,121320329,2,75543497,2004,161.7604386666667
639,40,2007-07-20,Hairspray,75000000,118871849,203035572,128035572,7,84163723,2007,170.714096
640,41,2013-05-31,Now You See Me,75000000,117723989,342769200,267769200,5,225045211,2013,357.0256
641,42,2006-12-15,Dreamgirls,75000000,103365956,155708695,80708695,12,52342739,2006,107.61159333333335
642,43,2018-08-03,Christopher Robin,75000000,99215042,197504758,122504758,8,98289716,2018,163.33967733333336
643,44,1999-07-23,Inspector Gadget,75000000,97387965,97387965,22387965,7,0,1999,29.85062
644,45,2011-11-11,Immortals,75000000,83504017,211562435,136562435,11,128058418,2011,182.08324666666667
645,46,2004-06-18,The Terminal,75000000,77073959,218673959,143673959,6,141600000,2004,191.56527866666667
646,47,2005-02-18,Constantine,75000000,75976178,221594911,146594911,2,145618733,2005,195.45988133333333
647,48,2006-07-21,Monster House,75000000,73661010,141267370,66267370,7,67606360,2006,88.35649333333333
648,49,2000-12-08,Vertical Limit,75000000,68473360,213500000,138500000,12,145026640,2000,184.66666666666666
649,50,2007-12-21,Charlie Wilson's War,75000000,66661095,119512771,44512771,12,52851676,2007,59.35036133333333
650,51,1999-04-16,Life,75000000,64062587,73521587,-1478413,4,9459000,1999,-1.9712173333333332
651,52,2005-03-04,Be Cool,75000000,55849401,94944017,19944017,3,39094616,2005,26.592022666666665
652,53,2005-12-23,Munich,75000000,47379090,131492772,56492772,12,84113682,2005,75.323696
653,54,2010-06-04,Killers,75000000,47059963,95572749,20572749,6,48512786,2010,27.430332
654,55,2015-08-14,The Man From U.N.C.L.E.,75000000,45445109,104949584,29949584,8,59504475,2015,39.93277866666667
655,56,2003-03-07,Tears of the Sun,75000000,43632458,85632458,10632458,3,42000000,2003,14.176610666666667
656,57,2006-07-21,Lady in the Water,75000000,42285169,72785169,-2214831,7,30500000,2006,-2.9531080000000003
657,58,2004-12-17,Spanglish,75000000,42044321,54344321,-20655679,12,12300000,2004,-27.54090533333333
658,59,2001-10-12,Bandits,75000000,41523271,71523271,-3476729,10,30000000,2001,-4.635638666666667
659,60,1999-12-17,Anna and the King,75000000,39251128,39251128,-35748872,12,0,1999,-47.66516266666667
660,61,1995-07-07,First Knight,75000000,37361412,127361412,52361412,7,90000000,1995,69.815216
661,62,2011-03-25,Sucker Punch,75000000,36392502,89758389,14758389,3,53365887,2011,19.677852
662,63,2005-03-11,Hostage,75000000,34636443,77636443,2636443,3,43000000,2005,3.5152573333333335
663,64,2016-10-28,Inferno,75000000,34343574,219519367,144519367,10,185175793,2016,192.69248933333333
664,65,2003-06-13,Hollywood Homicide,75000000,30207785,50409753,-24590247,6,20201968,2003,-32.786996
665,66,2000-06-16,Titan A.E.,75000000,22751979,36751979,-38248021,6,14000000,2000,-50.99736133333334
666,67,2004-12-17,Flight of the Phoenix,75000000,21009180,34009180,-40990820,12,13000000,2004,-54.654426666666666
667,68,1998-10-23,Soldier,75000000,14623082,14623082,-60376918,10,0,1998,-80.50255733333333
668,69,1999-01-15,Virus,75000000,14010690,30626690,-44373310,1,16616000,1999,-59.16441333333333
669,70,2001-02-23,Monkeybone,75000000,5409517,5409517,-69590483,2,0,2001,-92.78731066666667
670,71,2019-08-30,PLAYMOBIL,75000000,0,0,-75000000,8,0,2019,-100.0
671,72,2019-12-31,355,75000000,0,0,-75000000,12,0,2019,-100.0
672,73,2015-07-10,Minions,74000000,336045770,1160336173,1086336173,7,824290403,2015,1468.0218554054054
673,74,2015-02-06,The SpongeBob Movie: Sponge Out of Water,74000000,162994032,311013181,237013181,2,148019149,2015,320.2880824324324
674,75,2000-11-22,Unbreakable,73243106,94999143,248099143,174856037,11,153100000,2000,238.7337819889834
675,76,2006-08-04,Talladega Nights: The Ballad of Ricky Bobby,73000000,148213377,162870525,89870525,8,14657148,2006,123.11030821917808
676,77,2016-05-20,The Angry Birds Movie,73000000,107509366,352327887,279327887,5,244818521,2016,382.6409410958904
677,78,1998-08-07,Snake Eyes,73000000,55591409,103891409,30891409,8,48300000,1998,42.316998630136986
678,79,1998-02-13,Sphere,73000000,37068294,50168294,-22831706,2,13100000,1998,-31.276309589041094
679,80,2007-07-27,The Simpsons Movie,72500000,183135014,527071022,454571022,7,343936008,2007,626.9945131034483
680,81,2008-02-08,Fool's Gold,72500000,70231041,109362966,36862966,2,39131925,2008,50.84547034482758
681,82,2009-07-31,Funny People,72500000,51855045,71880305,-619695,7,20025260,2009,-0.854751724137931
682,83,2007-09-28,The Kingdom,72500000,47467250,86509602,14009602,9,39042352,2007,19.323588965517242
683,84,2001-06-22,Dr. Dolittle 2,72000000,112950721,176101721,104101721,6,63151000,2001,144.5857236111111
684,85,1995-05-24,Braveheart,72000000,75545647,209045244,137045244,5,133499597,1995,190.34061666666668
685,86,2005-11-04,Jarhead,72000000,62647540,96947540,24947540,11,34300000,2005,34.64936111111111
686,87,2001-04-27,Driven,72000000,32616869,54616869,-17383131,4,22000000,2001,-24.1432375
687,88,2001-12-21,The Majestic,72000000,27796042,37306334,-34693666,12,9510292,2001,-48.18564722222222
688,89,2004-06-25,Two Brothers,72000000,19176754,62176754,-9823246,6,43000000,2004,-13.643397222222223
689,90,2004-07-30,The Village,71682975,114197520,257641634,185958659,7,143444114,2004,259.4181658894598
690,91,1998-06-26,Doctor Dolittle,71500000,144156605,294156605,222656605,6,150000000,1998,311.40783916083916
691,92,2002-08-02,Signs,70702619,227969295,408269295,337566676,8,180300000,2002,477.4457874042827
692,93,2004-05-19,Shrek 2,70000000,441226247,937008132,867008132,5,495781885,2004,1238.5830457142856
693,94,2006-06-09,Cars,70000000,244082982,461651246,391651246,6,217568264,2006,559.5017799999999
694,95,2009-12-23,Alvin and the Chipmunks: The Squeakquel,70000000,219614612,443483213,373483213,12,223868601,2009,533.5474471428571
695,96,1988-06-22,Who Framed Roger Rabbit?,70000000,154112492,351500000,281500000,6,197387508,1988,402.1428571428571
696,97,1999-07-30,Runaway Bride,70000000,152257509,310138178,240138178,7,157880669,1999,343.05454000000003
697,98,2002-08-09,xXx,70000000,141930000,267200000,197200000,8,125270000,2002,281.7142857142857
698,99,2018-06-08,Oceanâs 8,70000000,140218711,297115976,227115976,6,156897265,2018,324.4513942857143
699,100,1996-11-08,Ransom,70000000,136492681,308700000,238700000,11,172207319,1996,341.0
700,1,2009-08-21,Inglourious Basterds,70000000,120774594,316915264,246915264,8,196140670,2009,352.7360914285714
701,2,1991-12-11,Hook,70000000,119654823,300854823,230854823,12,181200000,1991,329.7926042857143
702,3,1990-07-03,Die Hard 2,70000000,117323878,239814025,169814025,7,122490147,1990,242.59146428571427
703,4,2003-08-08,S.W.A.T.,70000000,116877597,207154748,137154748,8,90277151,2003,195.93535428571428
704,5,2017-11-10,Daddyâs Home 2,70000000,104029443,175807183,105807183,11,71777740,2017,151.15311857142856
705,6,1999-11-19,Sleepy Hollow,70000000,101068340,207068340,137068340,11,106000000,1999,195.8119142857143
706,7,2001-12-14,Vanilla Sky,70000000,100614858,202726605,132726605,12,102111747,2001,189.60943571428572
707,8,1997-06-13,Hercules,70000000,99112101,250700000,180700000,6,151587899,1997,258.14285714285717
708,9,2013-03-22,Olympus Has Fallen,70000000,98927592,172878928,102878928,3,73951336,2013,146.96989714285715
709,10,2011-03-11,Battle: Los Angeles,70000000,83552429,213463976,143463976,3,129911547,2011,204.94853714285713
710,11,2004-08-13,AVP: Alien Vs. Predator,70000000,80281096,172543519,102543519,8,92262423,2004,146.49074142857143
711,12,2011-12-25,War Horse,70000000,79883359,156815529,86815529,12,76932170,2011,124.02218428571427
712,13,2002-03-01,We Were Soldiers,70000000,78120196,114658262,44658262,3,36538066,2002,63.79751714285714
713,14,2014-02-07,The Monuments Men,70000000,78031620,158702748,88702748,2,80671128,2014,126.71821142857142
714,15,2016-09-23,Storks,70000000,72679278,183353431,113353431,9,110674153,2016,161.93347285714285
715,16,1998-12-11,Star Trek: Insurrection,70000000,70187658,117800000,47800000,12,47612342,1998,68.28571428571428
716,17,2003-12-10,Big Fish,70000000,66432867,123954323,53954323,12,57521456,2003,77.07760428571429
717,18,1994-06-17,Wolf,70000000,65011757,131011757,61011757,6,66000000,1994,87.15965285714286
718,19,2012-01-20,Underworld: Awakening,70000000,62321039,160379930,90379930,1,98058891,2012,129.11418571428572
719,20,2017-09-22,The Lego Ninjago Movie,70000000,59281555,122737201,52737201,9,63455646,2017,75.33885857142857
720,21,2014-10-10,Dracula Untold,70000000,55991880,220241723,150241723,10,164249843,2014,214.63103285714286
721,22,2006-09-29,The Guardian,70000000,55011732,94973540,24973540,9,39961808,2006,35.67648571428572
722,23,1989-08-09,The Abyss,70000000,54243125,54243125,-15756875,8,0,1989,-22.509821428571428
723,24,2010-09-24,Wall Street 2: Money Never Sleeps,70000000,52474616,137431619,67431619,9,84957003,2010,96.33088428571429
724,25,2011-01-14,The Dilemma,70000000,48475290,70546865,546865,1,22071575,2011,0.7812357142857143
725,26,2005-12-25,Rumor Has It,70000000,42996140,88933562,18933562,12,45937422,2005,27.047945714285714
726,27,1998-11-06,The Siege,70000000,40934175,116625798,46625798,11,75691623,1998,66.60828285714285
727,28,2007-08-10,Stardust,70000000,38634938,137022245,67022245,8,98387307,2007,95.74606428571428
728,29,2012-06-15,Rock of Ages,70000000,38518613,61031932,-8968068,6,22513319,2012,-12.811525714285715
729,30,1997-10-08,Seven Years in Tibet,70000000,37945884,131445884,61445884,10,93500000,1997,87.77983428571429
730,31,2004-09-17,Sky Captain and the World of Tomorrow,70000000,37760080,49730854,-20269146,9,11970774,2004,-28.95592285714286
731,32,2007-09-14,The Brave One,70000000,36793804,69792704,-207296,9,32998900,2007,-0.2961371428571429
732,33,2002-11-01,I Spy,70000000,33561137,60279822,-9720178,11,26718685,2002,-13.885968571428572
733,34,2002-06-07,Bad Company,70000000,30157016,69157016,-842984,6,39000000,2002,-1.204262857142857
734,35,2005-10-21,Doom,70000000,28212337,58757178,-11242822,10,30544841,2005,-16.061174285714287
735,36,2016-01-29,The Finest Hours,70000000,27569558,49252761,-20747239,1,21683203,2016,-29.638912857142856
736,37,2013-10-18,Escape Plan,70000000,25135965,103735965,33735965,10,78600000,2013,48.19423571428572
737,38,2011-09-23,Killer Elite,70000000,25124986,65409046,-4590954,9,40284060,2011,-6.558505714285714
738,39,1998-01-16,Hard Rain,70000000,19870567,19870567,-50129433,1,0,1998,-71.61347571428571
739,40,2002-02-15,Hart's War,70000000,19076815,33076815,-36923185,2,14000000,2002,-52.74740714285714
740,41,2002-02-08,Rollerball,70000000,18990542,25852508,-44147492,2,6861966,2002,-63.06784571428572
741,42,2014-01-10,The Legend of Hercules,70000000,18848538,58953319,-11046681,1,40104781,2014,-15.780972857142858
742,43,2007-04-27,Next,70000000,18211013,73591500,3591500,4,55380487,2007,5.130714285714285
743,44,2002-09-20,Ballistic: Ecks vs. Sever,70000000,14294842,14294842,-55705158,9,0,2002,-79.57879714285714
744,45,2001-08-10,Osmosis Jones,70000000,13596911,13596911,-56403089,8,0,2001,-80.57584142857142
745,46,2014-05-09,Legends of Oz: Dorothyâs Return,70000000,8462347,20107933,-49892067,5,11645586,2014,-71.27438142857143
746,47,2015-01-16,Blackhat,70000000,8005980,19665004,-50334996,1,11659024,2015,-71.90713714285715
747,48,2006-03-31,Basic Instinct 2,70000000,5946136,35417162,-34582838,3,29471026,2006,-49.40405428571429
748,49,2010-05-28,Agora,70000000,619423,38992292,-31007708,5,38372869,2010,-44.296725714285714
749,50,2010-07-09,Despicable Me,69000000,251513985,543464573,474464573,7,291950588,2010,687.6298159420289
750,51,2010-07-30,Dinner for Schmucks,69000000,73026337,86796502,17796502,7,13770165,2010,25.79203188405797
751,52,2018-03-02,Red Sparrow,69000000,46874505,145951861,76951861,3,99077356,2018,111.52443623188407
752,53,2010-06-30,The Twilight Saga: Eclipse,68000000,300531751,706102828,638102828,6,405571077,2010,938.3865117647058
753,54,2002-05-31,The Sum of All Fears,68000000,118471320,193500000,125500000,5,75028680,2002,184.55882352941177
754,55,2015-06-26,Ted 2,68000000,81476385,217214143,149214143,6,135737758,2015,219.4325632352941
755,56,2001-07-13,The Score,68000000,71069884,113542091,45542091,7,42472207,2001,66.97366323529413
756,57,2011-02-25,Hall Pass,68000000,45060734,87173475,19173475,2,42112741,2011,28.19628676470588
757,58,1995-11-22,Money Train,68000000,35324232,77224232,9224232,11,41900000,1995,13.565047058823529
758,59,2003-03-21,Dreamcatcher,68000000,33685268,75685268,7685268,3,42000000,2003,11.301864705882354
759,60,1999-08-06,Mystery Men,68000000,29762011,33462011,-34537989,8,3700000,1999,-50.791160294117645
760,61,1999-11-05,The Insider,68000000,28965197,60265197,-7734803,11,31300000,1999,-11.374710294117648
761,62,2017-12-22,Downsizing,68000000,24449754,54462971,-13537029,12,30013217,2017,-19.907395588235293
762,63,2012-03-02,Doctor Seuss' The Lorax,67500000,214030500,350976753,283476753,3,136946253,2012,419.96556
763,64,2008-10-10,Body of Lies,67500000,39394666,118556530,51056530,10,79161864,2008,75.6393037037037
764,65,2012-06-22,Abraham Lincoln: Vampire Hunter,67500000,37519139,137489730,69989730,6,99970591,2012,103.68848888888888
765,66,1996-09-20,Last Man Standing,67000000,18115927,18115927,-48884073,9,0,1996,-72.96130298507462
766,67,2007-08-17,The Last Legion,67000000,5932060,25357771,-41642229,8,19425711,2007,-62.152580597014925
767,68,1999-04-30,Entrapment,66000000,87707396,211700000,145700000,4,123992604,1999,220.75757575757575
768,69,1998-06-19,The X Files: Fight the Future,66000000,83898313,189176423,123176423,6,105278110,1998,186.63094393939394
769,70,2014-03-14,Need for Speed,66000000,43568507,194169619,128169619,3,150601112,2014,194.19639242424242
770,71,1998-07-24,Saving Private Ryan,65000000,216335085,485035085,420035085,7,268700000,1998,646.2078230769231
771,72,2000-12-15,What Women Want,65000000,182805123,374105123,309105123,12,191300000,2000,475.54634307692305
772,73,2012-11-09,Lincoln,65000000,182207973,273346281,208346281,11,91138308,2012,320.53274
773,74,2002-03-15,Ice Age,65000000,176387405,386116343,321116343,3,209728938,2002,494.0251430769231
774,75,1995-06-30,Apollo 13,65000000,173772767,335802271,270802271,6,162029504,1995,416.61887846153843
775,76,1999-03-31,The Matrix,65000000,171479930,463517383,398517383,3,292037453,1999,613.1036661538461
776,77,2018-07-13,Hotel Transylvania 3: Summer Vacation,65000000,167500092,527079962,462079962,7,359579870,2018,710.8922492307693
777,78,2012-12-25,Les Miserables,65000000,148809770,442169052,377169052,12,293359282,2012,580.2600799999999
778,79,2002-11-01,The Santa Clause 2,65000000,139225854,172825854,107825854,11,33600000,2002,165.88592923076925
779,80,1990-06-01,Total Recall,65000000,119394839,261400000,196400000,6,142005161,1990,302.1538461538462
780,81,1998-12-18,You've Got Mail,65000000,115821495,250800000,185800000,12,134978505,1998,285.84615384615387
781,82,2014-12-25,Unbroken,65000000,115637895,163527824,98527824,12,47889929,2014,151.58126769230768
782,83,2015-06-05,Spy!,65000000,110825712,232585748,167585748,6,121760036,2015,257.82422769230766
783,84,2010-11-05,Due Date,65000000,100539043,211739043,146739043,11,111200000,2010,225.75237384615386
784,85,2008-07-25,Step Brothers,65000000,100468793,128468793,63468793,7,28000000,2008,97.64429692307692
785,86,1995-12-15,Jumanji,65000000,100458310,262758310,197758310,12,162300000,1995,304.2435538461538
786,87,1998-07-17,The Mask of Zorro,65000000,93828745,233700000,168700000,7,139871255,1998,259.53846153846155
787,88,2000-08-04,Space Cowboys,65000000,90454043,128874043,63874043,8,38420000,2000,98.26775846153846
788,89,2014-12-19,Annie,65000000,85911262,139829625,74829625,12,53918363,2014,115.12249999999999
789,90,1993-05-28,Cliffhanger,65000000,84049211,255000000,190000000,5,170950789,1993,292.30769230769226
790,91,2016-08-12,Peteâs Dragon,65000000,76233151,137768975,72768975,8,61535824,2016,111.95226923076925
791,92,1996-02-09,Broken Arrow,65000000,70645997,148345997,83345997,2,77700000,1996,128.22461076923076
792,93,2006-08-09,World Trade Center,65000000,70278893,163295654,98295654,8,93016761,2006,151.22408307692308
793,94,2000-07-07,The Kid,65000000,69688384,69688384,4688384,7,0,2000,7.212898461538461
794,95,2003-12-19,Mona Lisa Smile,65000000,63803100,141205169,76205169,12,77402069,2003,117.23872153846153
795,96,2012-05-16,The Dictator,65000000,59650222,180148897,115148897,5,120498675,2012,177.15214923076923
796,97,1999-07-16,Eyes Wide Shut,65000000,55691208,104267443,39267443,7,48576235,1999,60.41145076923077
797,98,2012-02-17,This Means War,65000000,54760791,156974557,91974557,2,102213766,2012,141.49931846153848
798,99,2015-02-27,Focus,65000000,53862963,168065700,103065700,2,114202737,2015,158.56261538461538
799,100,2004-12-08,Blade: Trinity,65000000,52397389,131353165,66353165,12,78955776,2004,102.0817923076923
800,1,2012-11-21,Red Dawn,65000000,44806783,48164150,-16835850,11,3357367,2012,-25.90130769230769
801,2,2006-12-22,We Are Marshall,65000000,43545364,43545364,-21454636,12,0,2006,-33.0071323076923
802,3,2015-09-18,Everest,65000000,43482270,221297061,156297061,9,177814791,2015,240.4570169230769
803,4,2012-09-14,Resident Evil: Retribution,65000000,42345531,240647629,175647629,9,198302098,2012,270.2271215384616
804,5,1998-03-20,Primary Colors,65000000,39017984,39017984,-25982016,3,0,1998,-39.97233230769231
805,6,1999-10-15,Fight Club,65000000,37030102,100851705,35851705,10,63821603,1999,55.15646923076923
806,7,2008-08-22,Death Race,65000000,36316032,72516819,7516819,8,36200787,2008,11.564336923076922
807,8,1996-10-11,The Long Kiss Goodnight,65000000,33447612,33447612,-31552388,10,0,1996,-48.542135384615385
808,9,2000-12-08,Proof of Life,65000000,32598931,62761005,-2238995,12,30162074,2000,-3.4446076923076925
809,10,2005-11-11,Zathura,65000000,28045540,58545540,-6454460,11,30500000,2005,-9.92993846153846
810,11,2003-11-26,The Missing,65000000,26900336,38253433,-26746567,11,11353097,2003,-41.148564615384615
811,12,2005-01-14,Elektra,65000000,24409722,56824633,-8175367,1,32414911,2005,-12.577487692307693
812,13,2009-10-23,Astro Boy,65000000,19551067,41636243,-23363757,10,22085176,2009,-35.94424153846154
813,14,2014-01-24,"I, Frankenstein",65000000,19075290,74575290,9575290,1,55500000,2014,14.731215384615384
814,15,1991-05-24,Hudson Hawk,65000000,17218916,17218916,-47781084,5,0,1991,-73.50936
815,16,2014-08-22,Sin City: A Dame to Kill For,65000000,13757804,40650842,-24349158,8,26893038,2014,-37.46024307692308
816,17,2016-12-25,Live by Night,65000000,10378555,21774432,-43225568,12,11395877,2016,-66.50087384615384
817,18,2000-10-27,Lucky Numbers,65000000,10014234,10014234,-54985766,10,0,2000,-84.59348615384616
818,19,2005-09-23,Oliver Twist,65000000,2070920,26670920,-38329080,9,24600000,2005,-58.967815384615385
819,20,2015-09-04,Tian jiang xiong shi,65000000,74070,122519874,57519874,9,122445804,2015,88.49211384615384
820,21,2018-10-26,Air Strike,65000000,0,516279,-64483721,10,516279,2018,-99.20572461538461
821,22,2006-07-14,Little Man,64000000,58636047,101636047,37636047,7,43000000,2006,58.8063234375
822,23,1999-10-08,Random Hearts,64000000,31054924,63200000,-800000,10,32145076,1999,-1.25
823,24,2006-12-27,Perfume: The Story of a Murderer,63700000,2223293,133603463,69903463,12,131380170,2006,109.73856043956043
824,25,1993-06-11,Jurassic Park,63000000,395708305,1038812584,975812584,6,643104279,1993,1548.9088634920633
825,26,2002-07-25,Austin Powers in Goldmember,63000000,213117789,296338663,233338663,7,83220874,2002,370.3788301587302
826,27,2011-04-01,Hop,63000000,108085305,188657593,125657593,4,80572288,2011,199.45649682539684
827,28,2017-09-15,American Assassin,63000000,36249674,68310140,5310140,9,32060466,2017,8.42879365079365
828,29,1994-06-24,Wyatt Earp,63000000,25052000,25052000,-37948000,6,0,1994,-60.23492063492063
829,30,1994-08-03,Clear and Present Danger,62000000,122012656,207500000,145500000,8,85487344,1994,234.6774193548387
830,31,2000-04-21,U-571,62000000,77086030,127630030,65630030,4,50544000,2000,105.85488709677419
831,32,1995-11-17,The American President,62000000,60022813,107822813,45822813,11,47800000,1995,73.9077629032258
832,33,2015-12-25,The Hateful Eight,62000000,54117416,147864886,85864886,12,93747470,2015,138.49175161290324
833,34,2008-06-20,The Love Guru,62000000,32235793,40159017,-21840983,6,7923224,2008,-35.22739193548387
834,35,2001-02-23,3000 Miles to Graceland,62000000,15738632,18708848,-43291152,2,2970216,2001,-69.82443870967742
835,36,2014-10-03,Gone Girl,61000000,167767189,368567189,307567189,10,200800000,2014,504.20850655737706
836,37,2007-03-30,Blades of Glory,61000000,118594548,145594548,84594548,3,27000000,2007,138.6795868852459
837,38,2015-09-18,Maze Runner: The Scorch Trials,61000000,81697192,310566162,249566162,9,228868970,2015,409.12485573770493
838,39,2013-08-02,2 Guns,61000000,75612460,132493015,71493015,8,56880555,2013,117.20166393442624
839,40,2018-01-26,Maze Runner: The Death Cure,61000000,58032443,265878536,204878536,1,207846093,2018,335.8664524590164
840,41,2019-01-11,A Dogâs Way Home,61000000,41952715,81149689,20149689,1,39196974,2019,33.03227704918032
841,42,2016-02-19,Mei Ren Yu,60720000,3229457,554516671,493796671,2,551287214,2016,813.2356241765481
842,43,2004-12-22,Meet the Fockers,60000000,279167575,516567575,456567575,12,237400000,2004,760.9459583333332
843,44,2014-02-07,The Lego Movie,60000000,257784718,457729388,397729388,2,199944670,2014,662.8823133333333
844,45,2007-03-09,300,60000000,210614939,454161935,394161935,3,243546996,2007,656.9365583333333
845,46,2007-03-02,Wild Hogs,60000000,168213584,253555383,193555383,3,85341799,2007,322.592305
846,47,2008-12-25,Marley & Me,60000000,143153751,247812011,187812011,12,104658260,2008,313.0200183333333
847,48,1999-12-10,The Green Mile,60000000,136801374,290701374,230701374,12,153900000,1999,384.50229
848,49,1998-06-05,The Truman Show,60000000,125618201,264118201,204118201,6,138500000,1998,340.19700166666667
849,50,2016-09-09,Sully,60000000,125070033,238524556,178524556,9,113454523,2016,297.5409266666667
850,51,2002-06-14,The Bourne Identity,60000000,121468960,214357371,154357371,6,92888411,2002,257.262285
851,52,2009-10-09,Couples Retreat,60000000,109205660,172450423,112450423,10,63244763,2009,187.41737166666667
852,53,1995-11-17,Goldeneye,60000000,106429941,356429941,296429941,11,250000000,1995,494.04990166666664
853,54,2003-05-30,The Italian Job,60000000,106126012,176262839,116262839,5,70136827,2003,193.7713983333333
854,55,2003-05-09,Daddy Day Care,60000000,104148781,164285587,104285587,5,60136806,2003,173.80931166666667
855,56,1999-06-18,The General's Daughter,60000000,102705852,149705852,89705852,6,47000000,1999,149.50975333333335
856,57,1998-12-18,The Prince of Egypt,60000000,101413188,218613188,158613188,12,117200000,1998,264.35531333333336
857,58,2004-08-06,Collateral,60000000,100170152,217670152,157670152,8,117500000,2004,262.7835866666667
858,59,2001-07-04,Cats & Dogs,60000000,93375151,200700000,140700000,7,107324849,2001,234.50000000000003
859,60,2002-12-20,Two Weeks Notice,60000000,93354918,199043309,139043309,12,105688391,2002,231.73884833333332
860,61,1998-10-02,Antz,60000000,90757863,152457863,92457863,10,61700000,1998,154.09643833333334
861,62,2002-04-19,The Scorpion King,60000000,90580000,165890634,105890634,4,75310634,2002,176.48439
862,63,2010-10-15,Red,60000000,90380162,196439693,136439693,10,106059531,2010,227.39948833333332
863,64,2004-03-05,Starsky & Hutch,60000000,88200225,170200225,110200225,3,82000000,2004,183.66704166666668
864,65,1990-06-27,Days of Thunder,60000000,82670733,157670733,97670733,6,75000000,1990,162.784555
865,66,2005-12-21,Cheaper by the Dozen 2,60000000,82571173,135015330,75015330,12,52444157,2005,125.02555
866,67,2010-08-13,Eat Pray Love,60000000,80574010,206598789,146598789,8,126024779,2010,244.331315
867,68,2012-12-21,Jack Reacher,60000000,80070736,217370736,157370736,12,137300000,2012,262.28456
868,69,2004-04-23,Man on Fire,60000000,77906816,130968579,70968579,4,53061763,2004,118.28096500000001
869,70,2000-12-22,The Family Man,60000000,75764085,124715863,64715863,12,48951778,2000,107.85977166666667
870,71,2011-09-09,Contagion,60000000,75658097,137551594,77551594,9,61893497,2011,129.25265666666667
871,72,1999-12-22,Any Given Sunday,60000000,75530832,100230832,40230832,12,24700000,1999,67.05138666666667
872,73,1998-05-15,The Horse Whisperer,60000000,75383563,186883563,126883563,5,111500000,1998,211.472605
873,74,2009-02-06,Coraline,60000000,75286229,126037057,66037057,2,50750828,2009,110.06176166666665
874,75,2004-10-01,Ladder 49,60000000,74541707,102332848,42332848,10,27791141,2004,70.55474666666667
875,76,1999-07-28,Deep Blue Sea,60000000,73648228,165048228,105048228,7,91400000,1999,175.08038
876,77,2009-10-28,Michael Jackson's This Is It,60000000,72091016,252091016,192091016,10,180000000,2009,320.15169333333336
877,78,2003-01-17,Kangaroo Jack,60000000,66723216,90723216,30723216,1,24000000,2003,51.20536
878,79,2008-06-13,The Happening,60000000,64506874,162778384,102778384,6,98271510,2008,171.29730666666666
879,80,2016-03-04,London Has Fallen,60000000,62524260,195194085,135194085,3,132669825,2016,225.32347499999997
880,81,2000-04-07,Rules of Engagement,60000000,61322858,71719931,11719931,4,10397073,2000,19.533218333333334
881,82,2006-03-10,The Shaggy Dog,60000000,61123569,87123569,27123569,3,26000000,2006,45.20594833333333
882,83,1996-11-22,Jingle All the Way,60000000,60592389,129832389,69832389,11,69240000,1996,116.38731499999999
883,84,2004-04-02,Hellboy,60000000,59623958,99823958,39823958,4,40200000,2004,66.37326333333333
884,85,2016-10-21,Jack Reacher: Never Go Back,60000000,58697076,159946489,99946489,10,101249413,2016,166.57748166666667
885,86,2017-05-25,Baywatch,60000000,58060186,175863783,115863783,5,117803597,2017,193.106305
886,87,1998-12-25,A Civil Action,60000000,56709981,56709981,-3290019,12,0,1998,-5.483365
887,88,2015-12-25,Joy,60000000,56451232,101134059,41134059,12,44682827,2015,68.556765
888,89,2012-08-17,ParaNorman,60000000,56003051,108119662,48119662,8,52116611,2012,80.19943666666667
889,90,1997-11-14,The Jackal,60000000,54956941,159356941,99356941,11,104400000,1997,165.59490166666666
890,91,2003-12-25,Paycheck,60000000,53789313,98819789,38819789,12,45030476,2003,64.69964833333334
891,92,1996-03-01,Up Close & Personal,60000000,51045801,100645801,40645801,3,49600000,1996,67.74300166666667
892,93,2008-12-19,The Tale of Despereaux,60000000,50877145,90482317,30482317,12,39605172,2008,50.80386166666667
893,94,2014-09-26,The Boxtrolls,60000000,50837305,111946251,51946251,9,61108946,2014,86.577085
894,95,2017-08-04,The Dark Tower,60000000,50701325,113461527,53461527,8,62760202,2017,89.102545
895,96,2002-09-27,The Tuxedo,60000000,50586000,104429625,44429625,9,53843625,2002,74.049375
896,97,2014-01-17,Jack Ryan: Shadow Recruit,60000000,50577412,131377412,71377412,1,80800000,2014,118.96235333333334
897,98,1995-07-14,Under Siege 2: Dark Territory,60000000,50024083,104324083,44324083,7,54300000,1995,73.87347166666667
898,99,2005-03-24,Miss Congeniality 2: Armed and Fabulous,60000000,48478006,101382396,41382396,3,52904390,2005,68.97066
899,100,2018-12-25,Vice,60000000,47836282,70883171,10883171,12,23046889,2018,18.138618333333334
900,1,1997-11-26,Alien: Resurrection,60000000,47795018,160700000,100700000,11,112904982,1997,167.83333333333331
901,2,2007-03-23,Shooter,60000000,47003582,95538560,35538560,3,48534978,2007,59.23093333333333
902,3,1998-10-16,Practical Magic,60000000,46850558,68336997,8336997,10,21486439,1998,13.894994999999998
903,4,2013-01-11,Gangster Squad,60000000,46000903,104100903,44100903,1,58100000,2013,73.501505
904,5,2017-04-07,Smurfs: The Lost Village,60000000,45020282,197578586,137578586,4,152558304,2017,229.29764333333333
905,6,2018-10-12,First Man,60000000,44936545,105203825,45203825,10,60267280,2018,75.33970833333333
906,7,2009-06-19,Year One,60000000,43337279,57604723,-2395277,6,14267444,2009,-3.9921283333333335
907,8,2010-01-29,Edge of Darkness,60000000,43313890,82812456,22812456,1,39498566,2010,38.020759999999996
908,9,2002-12-13,Star Trek: Nemesis,60000000,43254409,67312826,7312826,12,24058417,2002,12.188043333333333
909,10,2002-02-19,Reign of Fire,60000000,43061982,82150183,22150183,2,39088201,2002,36.91697166666666
910,11,2009-11-20,Planet 51,60000000,42194060,108996113,48996113,11,66802053,2009,81.66018833333332
911,12,2009-03-20,Duplicity,60000000,40572825,81079566,21079566,3,40506741,2009,35.13261
912,13,2008-09-12,Righteous Kill,60000000,40081410,78481410,18481410,9,38400000,2008,30.80235
913,14,2009-12-11,Invictus,60000000,37491364,124514011,64514011,12,87022647,2009,107.52335166666667
914,15,2009-04-17,State of Play,60000000,37017955,88832210,28832210,4,51814255,2009,48.05368333333334
915,16,1999-02-12,My Favorite Martian,60000000,36850101,36850101,-23149899,2,0,1999,-38.583165
916,17,2006-04-21,The Sentinel,60000000,36280697,78080697,18080697,4,41800000,2006,30.134495
917,18,2012-09-21,Trouble with the Curve,60000000,35763137,47818913,-12181087,9,12055776,2012,-20.301811666666666
918,19,2003-10-10,Intolerable Cruelty,60000000,35327628,121327628,61327628,10,86000000,2003,102.21271333333333
919,20,1997-01-10,The Relic,60000000,33956608,33956608,-26043392,1,0,1997,-43.40565333333333
920,21,1998-04-03,Mercury Rising,60000000,32983332,32983332,-27016668,4,0,1998,-45.02778
921,22,2000-09-15,Almost Famous,60000000,32522352,47371191,-12628809,9,14848839,2000,-21.048015
922,23,2019-02-08,Cold Pursuit,60000000,32138862,62599159,2599159,2,30460297,2019,4.331931666666667
923,24,2002-12-06,Analyze That,60000000,32122249,54994757,-5005243,12,22872508,2002,-8.342071666666667
924,25,2009-04-24,The Soloist,60000000,31853584,38522450,-21477550,4,6668866,2009,-35.79591666666666
925,26,2013-08-21,The Mortal Instruments: City of Bones,60000000,31165421,75965567,15965567,8,44800146,2013,26.609278333333336
926,27,2000-11-03,The Legend of Bagger Vance,60000000,30695227,39235486,-20764514,11,8540259,2000,-34.60752333333333
927,28,2002-02-22,Dragonfly,60000000,30063805,30063805,-29936195,2,0,2002,-49.893658333333335
928,29,2011-05-13,Priest,60000000,29136626,84154026,24154026,5,55017400,2011,40.25671
929,30,2006-06-16,Garfield: A Tail of Two Kitties,60000000,28426747,147985373,87985373,6,119558626,2006,146.64228833333334
930,31,2005-04-29,XXX: State of the Union,60000000,26873932,71073932,11073932,4,44200000,2005,18.456553333333332
931,32,1997-08-15,Event Horizon,60000000,26673242,26673242,-33326758,8,0,1997,-55.54459666666667
932,33,2003-07-02,Sinbad: Legend of the Seven Seas,60000000,26483452,80767884,20767884,7,54284432,2003,34.61314
933,34,2005-07-08,Dark Water,60000000,25473093,49473093,-10526907,7,24000000,2005,-17.544845000000002
934,35,1998-08-14,The Avengers,60000000,23385416,48585416,-11414584,8,25200000,1998,-19.024306666666664
935,36,2006-09-15,The Black Dahlia,60000000,22672813,49238525,-10761475,9,26565712,2006,-17.935791666666667
936,37,1999-03-26,EDtv,60000000,22508689,35319689,-24680311,3,12811000,1999,-41.133851666666665
937,38,2008-12-25,The Spirit,60000000,19806188,39006188,-20993812,12,19200000,2008,-34.989686666666664
938,39,2001-10-19,The Last Castle,60000000,18208078,20541668,-39458332,10,2333590,2001,-65.76388666666666
939,40,2009-01-23,Inkheart,60000000,17303424,66655938,6655938,1,49352514,2009,11.09323
940,41,2000-01-14,Supernova,60000000,14218868,14816494,-45183506,1,597626,2000,-75.30584333333333
941,42,2006-09-22,Flyboys,60000000,13090630,14816379,-45183621,9,1725749,2006,-75.30603500000001
942,43,2014-02-14,Winterâs Tale,60000000,12600231,29575033,-30424967,2,16974802,2014,-50.70827833333333
943,44,1998-10-09,Holy Man,60000000,12069719,12069719,-47930281,10,0,1998,-79.88380166666667
944,45,2008-07-11,Meet Dave,60000000,11803254,50648806,-9351194,7,38845552,2008,-15.585323333333335
945,46,2005-08-12,The Great Raid,60000000,10166502,10597070,-49402930,8,430568,2005,-82.33821666666667
946,47,2017-02-24,Rock Dog,60000000,9420546,24148488,-35851512,2,14727942,2017,-59.75252
947,48,2015-01-23,Mortdecai,60000000,7696134,30396134,-29603866,1,22700000,2015,-49.339776666666666
948,49,2008-01-11,In the Name of the King: A Dungeon Siege Tale,60000000,4775656,13233220,-46766780,1,8457564,2008,-77.94463333333333
949,50,2003-10-24,Beyond Borders,60000000,4426297,11427090,-48572910,10,7000793,2003,-80.95485
950,51,2016-02-05,Xi You Ji zhi Sun Wu Kong San Da Bai Gu Jing,60000000,709982,194058503,134058503,2,193348521,2016,223.43083833333336
951,52,2015-12-11,The Ridiculous 6,60000000,0,0,-60000000,12,0,2015,-100.0
952,53,2019-11-08,Midway,59500000,0,0,-59500000,11,0,2019,-100.0
953,54,2018-03-23,Sherlock Gnomes,59000000,43242871,87527651,28527651,3,44284780,2018,48.35195084745762
954,55,2019-01-25,The Kid Who Would Be King,59000000,16790790,28348446,-30651554,1,11557656,2019,-51.951786440677964
955,56,2016-02-12,Deadpool,58000000,363070709,801025593,743025593,2,437954884,2016,1281.0786086206897
956,57,2014-12-25,American Sniper,58000000,350126372,547326372,489326372,12,197200000,2014,843.6661586206898
957,58,2015-10-16,Goosebumps,58000000,80069458,158905324,100905324,10,78835866,2015,173.97469655172412
958,59,1988-05-25,Rambo III,58000000,53715611,188715611,130715611,5,135000000,1988,225.37174310344827
959,60,1995-12-15,Sabrina,58000000,53458319,87100000,29100000,12,33641681,1995,50.172413793103445
960,61,2012-01-20,Red Tails,58000000,49876377,50365498,-7634502,1,489121,2012,-13.16293448275862
961,62,2005-09-16,Just Like Heaven,58000000,48318130,100687083,42687083,9,52368953,2005,73.59841896551724
962,63,2013-06-07,The Internship,58000000,44672764,93672764,35672764,6,49000000,2013,61.50476551724138
963,64,2000-04-28,The Flintstones in Viva Rock Vegas,58000000,35231365,59431365,1431365,4,24200000,2000,2.4678706896551725
964,65,2008-04-04,Leatherheads,58000000,31373938,41348628,-16651372,4,9974690,2008,-28.70926206896552
965,66,2017-03-24,Life,58000000,30234022,100929666,42929666,3,70695644,2017,74.01666551724138
966,67,2009-12-18,Did You Hear About the Morgans?,58000000,29580087,80480566,22480566,12,50900479,2009,38.759596551724144
967,68,2008-12-12,"Che, Part 1: The Argentine",58000000,1802521,31627370,-26372630,12,29824849,2008,-45.47005172413793
968,69,2008-05-30,Sex and the City,57500000,152647258,415247258,357747258,5,262600000,2008,622.1691443478261
969,70,2010-09-10,Resident Evil: Afterlife,57500000,60128566,295874190,238374190,9,235745624,2010,414.5638086956522
970,71,2012-06-15,That's My Boy,57500000,36931089,58085235,585235,6,21154146,2012,1.0178
971,72,1997-10-17,Devil's Advocate,57000000,61007424,153007424,96007424,10,92000000,1997,168.43407719298244
972,73,2012-02-17,Ghost Rider: Spirit of Vengeance,57000000,51774002,149217355,92217355,2,97443353,2012,161.78483333333332
973,74,1996-05-31,Dragonheart,57000000,51364680,104364680,47364680,5,53000000,1996,83.0959298245614
974,75,2004-11-12,After the Sunset,57000000,28328132,38329114,-18670886,11,10000982,2004,-32.7559403508772
975,76,2001-08-17,Captain Corelli's Mandolin,57000000,25528495,62097495,5097495,8,36569000,2001,8.942973684210525
976,77,2014-12-25,Into the Woods,56200000,128002372,213116401,156916401,12,85114029,2014,279.21067793594307
977,78,2003-04-11,Anger Management,56000000,135560942,195660942,139660942,4,60100000,2003,249.3945392857143
978,79,2005-03-04,The Pacifier,56000000,113006880,198006880,142006880,3,85000000,2005,253.58371428571428
979,80,2004-04-02,Walking Tall,56000000,46213824,47313824,-8686176,4,1100000,2004,-15.51102857142857
980,81,2016-01-22,Zhuo yao ji,56000000,32766,359495591,303495591,1,359462825,2016,541.9564124999999
981,82,1994-07-06,Forrest Gump,55000000,330151138,679850637,624850637,7,349699499,1994,1136.0920672727273
982,83,2007-12-14,Alvin and the Chipmunks,55000000,217326974,362605033,307605033,12,145278059,2007,559.2818781818182
983,84,2018-11-02,Bohemian Rhapsody,55000000,216303339,894985342,839985342,11,678682003,2018,1527.2460763636363
984,85,2005-02-11,Hitch,55000000,177784257,366784257,311784257,2,189000000,2005,566.8804672727273
985,86,2000-10-06,Meet the Parents,55000000,166225040,330425040,275425040,10,164200000,2000,500.7728
986,87,2006-12-15,The Pursuit of Happyness,55000000,162586036,307311093,252311093,12,144725057,2006,458.7474418181818
987,88,1995-06-10,Pocahontas,55000000,141579773,347100000,292100000,6,205520227,1995,531.090909090909
988,89,1978-12-15,Superman,55000000,134218018,300200000,245200000,12,165981982,1978,445.8181818181818
989,90,1996-06-28,The Nutty Professor,55000000,128814019,273814019,218814019,6,145000000,1996,397.8436709090909
990,91,2017-02-10,Fifty Shades Darker,55000000,114434010,381398492,326398492,2,266964482,2017,593.4518036363636
991,92,2013-10-11,Captain Phillips,55000000,107136417,220648184,165648184,10,113511767,2013,301.1785163636364
992,93,1997-07-16,George Of The Jungle,55000000,105263257,174463257,119463257,7,69200000,1997,217.20592181818182
993,94,2003-08-01,American Wedding,55000000,104354205,126425115,71425115,8,22070910,2003,129.86384545454547
994,95,2017-11-10,Murder on the Orient Express,55000000,102826543,345922730,290922730,11,243096187,2017,528.9504181818182
995,96,2014-09-26,The Equalizer,55000000,101530738,192903624,137903624,9,91372886,2014,250.7338618181818
996,97,2018-02-09,Fifty Shades Freed,55000000,100407760,371350619,316350619,2,270942859,2018,575.1829436363637
997,98,1995-05-26,Casper,55000000,100328194,282300000,227300000,5,181971806,1995,413.27272727272725
998,99,2010-04-09,Date Night,55000000,98711404,152269033,97269033,4,53557629,2010,176.85278727272726
999,100,2002-12-13,Maid in Manhattan,55000000,93932896,163838217,108838217,12,69905321,2002,197.88766727272727
1000,1,1995-05-12,Crimson Tide,55000000,91387195,159387195,104387195,5,68000000,1995,189.7949
1001,2,2005-09-23,Flightplan,55000000,89706988,214392904,159392904,9,124685916,2005,289.80528
1002,3,1994-12-09,Disclosure,55000000,83015089,212200000,157200000,12,129184911,1994,285.8181818181818
1003,4,1998-04-10,City of Angels,55000000,78750909,198750909,143750909,4,120000000,1998,261.36528909090913
1004,5,2015-01-16,Paddington,55000000,76223578,258789097,203789097,1,182565519,2015,370.5256309090909
1005,6,2006-04-28,R.V.,55000000,71724497,87473024,32473024,4,15748527,2006,59.041861818181815
1006,7,1994-10-28,Stargate,55000000,71565669,196565669,141565669,10,125000000,1994,257.39212545454546
1007,8,2003-10-10,Kill Bill: Volume 1,55000000,70098138,176469428,121469428,10,106371290,2003,220.85350545454548
1008,9,2011-06-17,Mr. Poppers's Penguins,55000000,68224452,189624452,134624452,6,121400000,2011,244.77173090909093
1009,10,1999-08-13,Bowfinger,55000000,66458769,98699769,43699769,8,32241000,1999,79.45412545454545
1010,11,2004-04-16,Kill Bill: Volume 2,55000000,66207920,153535982,98535982,4,87328062,2004,179.1563309090909
1011,12,1989-12-22,Tango & Cash,55000000,63408614,63408614,8408614,12,0,1989,15.28838909090909
1012,13,1992-07-31,Death Becomes Her,55000000,58422650,149022650,94022650,7,90600000,1992,170.95027272727273
1013,14,2000-05-26,Shanghai Noon,55000000,56932305,71189835,16189835,5,14257530,2000,29.436063636363635
1014,15,1996-03-15,Executive Decision,55000000,56679192,122079192,67079192,3,65400000,1996,121.96216727272726
1015,16,2013-11-01,Free Birds,55000000,55750480,110387072,55387072,11,54636592,2013,100.70376727272728
1016,17,1992-05-22,Alien 3,55000000,54927174,158500000,103500000,5,103572826,1992,188.1818181818182
1017,18,2008-04-18,The Forbidden Kingdom,55000000,52075270,129075270,74075270,4,77000000,2008,134.6823090909091
1018,19,2004-12-22,The Phantom of the Opera,55000000,51225796,153770052,98770052,12,102544256,2004,179.58191272727274
1019,20,2014-03-21,Muppets Most Wanted,55000000,51178893,79312301,24312301,3,28133408,2014,44.20418363636364
1020,21,1996-12-25,Evita,55000000,50047179,151947179,96947179,12,101900000,1996,176.2675981818182
1021,22,2016-08-19,Kubo and the Two Strings,55000000,48023088,77548122,22548122,8,29525034,2016,40.99658545454545
1022,23,1998-09-25,Ronin,55000000,41610884,70692101,15692101,9,29081217,1998,28.53109272727273
1023,24,2010-11-24,Burlesque,55000000,39440655,90552675,35552675,11,51112020,2010,64.64122727272728
1024,25,1996-10-11,The Ghost and the Darkness,55000000,38564422,38564422,-16435578,10,0,1996,-29.882869090909093
1025,26,2008-10-24,Changeling,55000000,35739802,113805580,58805580,10,78065778,2008,106.91923636363636
1026,27,2012-07-27,The Watch,55000000,34353000,67130045,12130045,7,32777045,2012,22.054627272727274
1027,28,2003-03-14,The Hunted,55000000,34234008,47213095,-7786905,3,12979087,2003,-14.15800909090909
1028,29,1999-06-04,Instinct,55000000,34105207,34105207,-20894793,6,0,1999,-37.99053272727273
1029,30,2003-12-12,Stuck On You,55000000,33832741,63537164,8537164,12,29704423,2003,15.522116363636362
1030,31,2008-02-29,Semi-Pro,55000000,33479698,43980363,-11019637,2,10500665,2008,-20.035703636363635
1031,32,2018-02-23,Annihilation,55000000,32732301,43070915,-11929085,2,10338614,2018,-21.689245454545457
1032,33,2015-10-16,Crimson Peak,55000000,31090320,74966854,19966854,10,43876534,2015,36.30337090909091
1033,34,2012-04-27,The Pirates! Band of Misfits,55000000,31051126,136143605,81143605,4,105092479,2012,147.53382727272728
1034,35,2005-12-02,Aeon Flux,55000000,25857987,53913573,-1086427,12,28055586,2005,-1.9753218181818182
1035,36,1996-08-02,Chain Reaction,55000000,21226204,60209334,5209334,8,38983130,1996,9.471516363636363
1036,37,1996-08-16,The Fan,55000000,18582965,18582965,-36417035,8,0,1996,-66.21279090909091
1037,38,2007-10-12,Elizabeth: The Golden Age,55000000,16285240,74870866,19870866,10,58585626,2007,36.12884727272727
1038,39,2009-06-12,Imagine That,55000000,16222392,22438144,-32561856,6,6215752,2009,-59.203374545454544
1039,40,2003-02-21,Gods and Generals,55000000,12882934,12923936,-42076064,2,41002,2003,-76.50193454545455
1040,41,1997-01-10,Turbulence,55000000,11532774,11532774,-43467226,1,0,1997,-79.03132000000001
1041,42,2013-02-01,Bullet to the Head,55000000,9489829,22597969,-32402031,2,13108140,2013,-58.91278363636364
1042,43,2006-09-22,All the King's Men,55000000,7221458,9521458,-45478542,9,2300000,2006,-82.68825818181818
1043,44,2004-07-30,Thunderbirds,55000000,6768055,28231444,-26768556,7,21463389,2004,-48.67010181818181
1044,45,2004-11-26,Un long dimanche de fianÃ§ailles,55000000,6167817,69759296,14759296,11,63591479,2004,26.83508363636364
1045,46,2007-05-04,Lucky You,55000000,5755286,6521829,-48478171,5,766543,2007,-88.1421290909091
1046,47,1998-07-22,Lolita,55000000,1147784,1147784,-53852216,7,0,1998,-97.91311999999999
1047,48,2002-09-20,Eye See You,55000000,79161,1807990,-53192010,9,1728829,2002,-96.71274545454546
1048,49,1981-06-19,Superman II,54000000,108185706,108185706,54185706,6,0,1981,100.34389999999999
1049,50,2002-03-22,Blade 2,54000000,81676888,154338601,100338601,3,72661713,2002,185.81222407407407
1050,51,2006-07-14,"You, Me and Dupree",54000000,75802010,130402010,76402010,7,54600000,2006,141.4852037037037
1051,52,2008-12-19,Seven Pounds,54000000,69951824,166617328,112617328,12,96665504,2008,208.5506074074074
1052,53,1990-12-25,The Godfather: Part III,54000000,66520529,66520529,12520529,12,0,1990,23.186164814814813
1053,54,2005-10-14,Elizabethtown,54000000,26850426,50719373,-3280627,10,23868947,2005,-6.075235185185185
1054,55,2003-08-01,Gigli,54000000,6087542,7126002,-46873998,8,1038460,2003,-86.80369999999999
1055,56,2000-06-16,Shaft,53012938,70327868,107190108,54177170,6,36862240,2000,102.19612804708164
1056,57,2005-08-05,The Dukes of Hazzard,53000000,80270227,109848461,56848461,8,29578234,2005,107.26124716981131
1057,58,2009-10-16,Law Abiding Citizen,53000000,73357727,131159781,78159781,10,57802054,2009,147.47128490566038
1058,59,2015-09-18,Black Mass,53000000,62575678,98837872,45837872,9,36262194,2015,86.48655094339622
1059,60,1997-11-14,Anastasia,53000000,58403409,139801096,86801096,11,81397687,1997,163.77565283018868
1060,61,2001-05-18,Moulin Rouge,53000000,57386369,179200588,126200588,5,121814219,2001,238.11431698113208
1061,62,2001-11-02,Domestic Disturbance,53000000,45207112,54207112,1207112,11,9000000,2001,2.2775698113207548
1062,63,2006-10-20,Flags of Our Fathers,53000000,33602376,63657941,10657941,10,30055565,2006,20.109322641509433
1063,64,2007-04-06,Grindhouse,53000000,25031037,50187789,-2812211,4,25156752,2007,-5.306058490566038
1064,65,1998-10-16,Beloved,53000000,22852487,22852487,-30147513,10,0,1998,-56.8821
1065,66,2012-12-19,Zero Dark Thirty,52500000,95720716,134612435,82112435,12,38891719,2012,156.4046380952381
1066,67,2002-12-25,Catch Me if You Can,52000000,164606800,355612291,303612291,12,191005491,2002,583.8697903846154
1067,68,2008-07-18,Mamma Mia!,52000000,144130063,615748772,563748772,7,471618709,2008,1084.1322538461538
1068,69,2006-06-02,The Break-Up,52000000,118703275,205727307,153727307,6,87024032,2006,295.6294365384615
1069,70,2010-02-12,Valentine's Day,52000000,110485654,217569328,165569328,2,107083674,2010,318.40255384615386
1070,71,1995-11-22,Casino,52000000,42438300,110400000,58400000,11,67961700,1995,112.3076923076923
1071,72,2011-08-05,The Change-Up,52000000,37243418,75997067,23997067,8,38753649,2011,46.14820576923077
1072,73,1998-12-23,The Thin Red Line,52000000,36400491,97709034,45709034,12,61308543,1998,87.90198846153847
1073,74,1999-12-22,Man on the Moon,52000000,34580635,47407635,-4592365,12,12827000,1999,-8.831471153846154
1074,75,2010-02-05,From Paris With Love,52000000,24077427,53139168,1139168,2,29061741,2010,2.1907076923076922
1075,76,2003-04-16,Bulletproof Monk,52000000,23010607,23010607,-28989393,4,0,2003,-55.748832692307694
1076,77,2000-06-23,"Me, Myself & Irene",51000000,90570999,149270999,98270999,6,58700000,2000,192.68823333333333
1077,78,2006-08-04,Barnyard: The Original Party Animals,51000000,72779000,118583844,67583844,8,45804844,2006,132.51734117647058
1078,79,2018-08-17,Alpha,51000000,35851379,99624873,48624873,8,63773494,2018,95.34288823529413
1079,80,2006-11-22,Deck the Halls,51000000,35093569,46815807,-4184193,11,11722238,2006,-8.2043
1080,81,2011-03-04,The Adjustment Bureau,50200000,62495645,126931325,76731325,3,64435680,2011,152.8512450199203
1081,82,2009-11-20,The Twilight Saga: New Moon,50000000,296623634,687557727,637557727,11,390934093,2009,1275.115454
1082,83,2001-05-18,Shrek,50000000,267655011,491812794,441812794,5,224157783,2001,883.625588
1083,84,2012-06-29,Ted,50000000,218665740,556016627,506016627,6,337350887,2012,1012.0332539999999
1084,85,2014-06-13,22 Jump Street,50000000,191719337,331333876,281333876,6,139614539,2014,562.6677520000001
1085,86,1991-06-14,Robin Hood: Prince of Thieves,50000000,165493908,390500000,340500000,6,225006092,1991,681.0
1086,87,1996-12-13,Jerry Maguire,50000000,153952592,274000000,224000000,12,120047408,1996,448.00000000000006
1087,88,2015-12-25,Daddyâs Home,50000000,150357137,242757137,192757137,12,92400000,2015,385.514274
1088,89,1997-12-24,As Good as it Gets,50000000,148478011,314111923,264111923,12,165633912,1997,528.223846
1089,90,1998-12-25,Patch Adams,50000000,135014968,202173000,152173000,12,67158032,1998,304.346
1090,91,2016-06-17,Central Intelligence,50000000,127440871,217194805,167194805,6,89753934,2016,334.38961
1091,92,2013-12-18,Anchorman 2: The Legend Continues,50000000,127352707,172185754,122185754,12,44833047,2013,244.371508
1092,93,2011-06-10,Super 8,50000000,127004179,257972745,207972745,6,130968566,2011,415.94549
1093,94,2002-06-28,Mr. Deeds,50000000,126293452,171269535,121269535,6,44976083,2002,242.53906999999998
1094,95,2000-03-17,Erin Brockovich,50000000,125548685,257805243,207805243,3,132256558,2000,415.61048600000004
1095,96,2018-11-21,Creed II,50000000,115715889,213591522,163591522,11,97875633,2018,327.183044
1096,97,2018-02-09,Peter Rabbit,50000000,115234093,347136477,297136477,2,231902384,2018,594.272954
1097,98,2003-02-07,How to Lose a Guy in 10 Days,50000000,105807520,178890782,128890782,2,73083262,2003,257.781564
1098,99,1994-11-11,Interview with the Vampire: The Vampire Chronicles,50000000,105264608,223564608,173564608,11,118300000,1994,347.129216
1099,100,2018-12-14,The Mule,50000000,103804407,170857676,120857676,12,67053269,2018,241.715352
1100,1,2008-12-19,Yes Man,50000000,97690976,225990976,175990976,12,128300000,2008,351.981952
1101,2,2014-02-28,Non-Stop,50000000,91742160,222383055,172383055,2,130640895,2014,344.76610999999997
1102,3,1998-12-25,Stepmom,50000000,91137662,159745279,109745279,12,68607617,1998,219.490558
1103,4,2013-08-09,Disney Planes,50000000,90282580,238059569,188059569,8,147776989,2013,376.119138
1104,5,2006-03-10,Failure to Launch,50000000,88715192,128402901,78402901,3,39687709,2006,156.805802
1105,6,2006-03-24,Inside Man,50000000,88634237,185798265,135798265,3,97164028,2006,271.59653000000003
1106,7,2017-07-28,The Emoji Movie,50000000,86089513,216562312,166562312,7,130472799,2017,333.124624
1107,8,2011-07-29,"Crazy, Stupid, Love",50000000,84351197,147142328,97142328,7,62791131,2011,194.284656
1108,9,2017-12-22,The Post,50000000,81903458,179748880,129748880,12,97845422,2017,259.49775999999997
1109,10,1999-02-05,Payback,50000000,81526121,161626121,111626121,2,80100000,1999,223.252242
1110,11,1995-06-09,Congo,50000000,81022333,152022333,102022333,6,71000000,1995,204.044666
1111,12,2009-03-20,Knowing,50000000,79957634,186450317,136450317,3,106492683,2009,272.900634
1112,13,2005-03-18,The Ring Two,50000000,75941727,161941727,111941727,3,86000000,2005,223.883454
1113,14,2011-12-23,We Bought a Zoo,50000000,75624550,118729073,68729073,12,43104523,2011,137.458146
1114,15,2011-09-23,Moneyball,50000000,75605492,111300835,61300835,9,35695343,2011,122.60167
1115,16,2004-06-11,Garfield: The Movie,50000000,75367693,208094550,158094550,6,132726857,2004,316.1891
1116,17,2004-11-24,Christmas with the Kranks,50000000,73701902,96469187,46469187,11,22767285,2004,92.938374
1117,18,2006-03-17,V for Vendetta,50000000,70511035,130214162,80214162,3,59703127,2006,160.428324
1118,19,1995-03-10,Outbreak,50000000,67823573,190023573,140023573,3,122200000,1995,280.047146
1119,20,2009-03-13,Race to Witch Mountain,50000000,67172595,105103784,55103784,3,37931189,2009,110.207568
1120,21,2004-09-24,The Forgotten,50000000,66711892,117211892,67211892,9,50500000,2004,134.42378399999998
1121,22,2005-06-22,Herbie: Fully Loaded,50000000,66010682,144110682,94110682,6,78100000,2005,188.221364
1122,23,2003-02-07,Shanghai Knights,50000000,60470220,88316835,38316835,2,27846615,2003,76.63367
1123,24,2014-07-18,Planes: Fire and Rescue,50000000,59157732,156399644,106399644,7,97241912,2014,212.799288
1124,25,2006-02-10,Curious George,50000000,58640119,71052604,21052604,2,12412485,2006,42.105208
1125,26,2012-04-06,American Reunion,50000000,56758835,236799211,186799211,4,180040376,2012,373.598422
1126,27,2013-01-25,Hansel & Gretel: Witch Hunters,50000000,55703475,214949716,164949716,1,159246241,2013,329.899432
1127,28,2011-02-18,I am Number Four,50000000,55100437,146195159,96195159,2,91094722,2011,192.39031799999998
1128,29,2001-09-28,Donât Say a Word,50000000,54997476,104488383,54488383,9,49490907,2001,108.976766
1129,30,2016-01-15,13 Hours: The Secret Soldiers of Benghazi,50000000,52853219,69411370,19411370,1,16558151,2016,38.82274
1130,31,2002-05-08,Unfaithful,50000000,52752475,119114494,69114494,5,66362019,2002,138.22898800000002
1131,32,2017-09-29,American Made,50000000,51342000,135569212,85569212,9,84227212,2017,171.138424
1132,33,2005-11-23,Syriana,50000000,50824620,92690959,42690959,11,41866339,2005,85.381918
1133,34,2004-09-10,Resident Evil: Apocalypse,50000000,50740078,125168734,75168734,9,74428656,2004,150.337468
1134,35,2014-10-17,The Book of Life,50000000,50151543,97651543,47651543,10,47500000,2014,95.30308600000001
1135,36,1997-02-14,Absolute Power,50000000,50068310,50068310,68310,2,0,1997,0.13662
1136,37,2006-02-10,Firewall,50000000,48751189,82751189,32751189,2,34000000,2006,65.50237800000001
1137,38,1997-09-12,The Game,50000000,48265581,80369970,30369970,9,32104389,1997,60.739940000000004
1138,39,1997-08-22,G.I. Jane,50000000,48169156,48169156,-1830844,8,0,1997,-3.661688
1139,40,2014-08-08,Into the Storm,50000000,47602194,150429371,100429371,8,102827177,2014,200.858742
1140,41,2014-10-10,The Judge,50000000,47119388,76119388,26119388,10,29000000,2014,52.238776
1141,42,2006-04-21,Silent Hill,50000000,46982632,94704227,44704227,4,47721595,2006,89.408454
1142,43,2000-08-11,The Replacements,50000000,44737059,50054511,54511,8,5317452,2000,0.10902200000000001
1143,44,1998-07-29,The Negotiator,50000000,44705766,49105766,-894234,7,4400000,1998,-1.788468
1144,45,2016-08-19,War Dogs,50000000,43034523,86234503,36234503,8,43199980,2016,72.46900600000001
1145,46,1994-05-25,Beverly Hills Cop III,50000000,42586861,119180938,69180938,5,76594077,1994,138.361876
1146,47,1990-06-15,Gremlins 2: The New Batch,50000000,41476097,41476097,-8523903,6,0,1990,-17.047805999999998
1147,48,1997-09-26,The Peacemaker,50000000,41263140,62967368,12967368,9,21704228,1997,25.934736
1148,49,2003-10-03,Out of Time,50000000,41083108,55489826,5489826,10,14406718,2003,10.979652
1149,50,2004-11-12,Bridget Jones: The Edge Of Reason,50000000,40203020,263894551,213894551,11,223691531,2004,427.789102
1150,51,2000-02-11,The Beach,50000000,39778599,39778599,-10221401,2,0,2000,-20.442802
1151,52,2005-06-10,The Adventures of Sharkboy and Lavagirl in 3-D,50000000,39177684,69425966,19425966,6,30248282,2005,38.851932
1152,53,1994-02-18,On Deadly Ground,50000000,38590458,38590458,-11409542,2,0,1994,-22.819084
1153,54,2009-11-25,Ninja Assassin,50000000,38122883,62209892,12209892,11,24087009,2009,24.419784
1154,55,2004-05-28,Raising Helen,50000000,37485528,49928680,-71320,5,12443152,2004,-0.14264
1155,56,2016-05-20,The Nice Guys,50000000,36261763,59596747,9596747,5,23334984,2016,19.193494
1156,57,1999-09-17,For Love of the Game,50000000,35188640,46112640,-3887360,9,10924000,1999,-7.77472
1157,58,1998-12-11,Jack Frost,50000000,34645374,34645374,-15354626,12,0,1998,-30.709252
1158,59,2010-06-04,Marmaduke,50000000,33644788,89895930,39895930,6,56251142,2010,79.79186
1159,60,1996-06-28,Striptease,50000000,33109743,113309743,63309743,6,80200000,1996,126.619486
1160,61,2010-10-15,Hereafter,50000000,32746941,108660270,58660270,10,75913329,2010,117.32054000000001
1161,62,2002-04-19,Murder by Numbers,50000000,31874869,56643267,6643267,4,24768398,2002,13.286534
1162,63,1995-10-06,Assassins,50000000,30306268,83306268,33306268,10,53000000,1995,66.612536
1163,64,2016-02-12,Zoolander 2,50000000,28848693,55348693,5348693,2,26500000,2016,10.697386
1164,65,2009-01-16,Defiance,50000000,28644813,52987754,2987754,1,24342941,2009,5.9755080000000005
1165,66,2007-02-09,Hannibal Rising,50000000,27669725,80583311,30583311,2,52913586,2007,61.166622000000004
1166,67,1999-10-15,The Story of Us,50000000,27100030,27100030,-22899970,10,0,1999,-45.79994
1167,68,2013-03-29,The Host,50000000,26623701,64477051,14477051,3,37853350,2013,28.954102
1168,69,2003-03-28,Basic,50000000,26599248,42598498,-7401502,3,15999250,2003,-14.803004
1169,70,2015-03-13,Run All Night,50000000,26461644,66961644,16961644,3,40500000,2015,33.923288
1170,71,2002-08-09,Blood Work,50000000,26199517,26199517,-23800483,8,0,2002,-47.600966
1171,72,2009-02-13,The International,50000000,25450527,53850527,3850527,2,28400000,2009,7.701054
1172,73,1996-08-09,Escape from L.A.,50000000,25426861,25426861,-24573139,8,0,1996,-49.146277999999995
1173,74,2004-02-27,Twisted,50000000,25195050,40119848,-9880152,2,14924798,2004,-19.760304
1174,75,2004-12-10,The Life Aquatic with Steve Zissou,50000000,24006726,34806726,-15193274,12,10800000,2004,-30.386548
1175,76,1999-08-04,The Iron Giant,50000000,23159305,31333917,-18666083,8,8174612,1999,-37.332166
1176,77,2019-04-12,Hellboy,50000000,21903748,40725492,-9274508,4,18821744,2019,-18.549015999999998
1177,78,2011-04-08,Your Highness,50000000,21596445,26121638,-23878362,4,4525193,2011,-47.756724
1178,79,2016-09-16,Snowden,50000000,21587519,35380918,-14619082,9,13793399,2016,-29.238164
1179,80,2011-09-30,Dream House,50000000,21302340,41642166,-8357834,9,20339826,2011,-16.715668
1180,81,2016-06-24,Free State of Jones,50000000,20810036,23237252,-26762748,6,2427216,2016,-53.525496
1181,82,2009-09-04,Gamer,50000000,20534907,42002029,-7997971,9,21467122,2009,-15.995942
1182,83,2005-02-25,Man of the House,50000000,19699706,22099706,-27900294,2,2400000,2005,-55.800588
1183,84,2003-02-21,The Life of David Gale,50000000,19694635,28920188,-21079812,2,9225553,2003,-42.159624
1184,85,2013-02-14,Beautiful Creatures,50000000,19452138,60282876,10282876,2,40830738,2013,20.565752
1185,86,2005-09-30,Into the Blue,50000000,18782227,41982227,-8017773,9,23200000,2005,-16.035546
1186,87,2007-09-14,Eastern Promises,50000000,17181265,56077088,6077088,9,38895823,2007,12.154176
1187,88,1994-07-01,Baby's Day Out,50000000,16581575,16581575,-33418425,7,0,1994,-66.83685
1188,89,1999-11-12,The Messenger: The Story of Joan of Arc,50000000,14271297,14271297,-35728703,11,0,1999,-71.457406
1189,90,1995-11-03,Fair Game,50000000,11497497,26097497,-23902503,11,14600000,1995,-47.805006
1190,91,2011-02-25,Drive Angry,50000000,10721033,41042583,-8957417,2,30321550,2011,-17.914834
1191,92,1997-11-07,Mad City,50000000,10561038,10561038,-39438962,11,0,1997,-78.877924
1192,93,1995-10-13,The Scarlet Letter,50000000,10359006,10359006,-39640994,10,0,1995,-79.281988
1193,94,2005-10-14,Domino,50000000,10169202,23574057,-26425943,10,13404855,2005,-52.851886
1194,95,1995-10-13,Jade,50000000,9812870,9812870,-40187130,10,0,1995,-80.37425999999999
1195,96,2009-02-27,Street Fighter: The Legend of Chun-Li,50000000,8742261,12660287,-37339713,2,3918026,2009,-74.679426
1196,97,2002-03-29,Death to Smoochy,50000000,8355815,8374062,-41625938,3,18247,2002,-83.251876
1197,98,2018-02-16,Early Man,50000000,8267544,45285890,-4714110,2,37018346,2018,-9.42822
1198,99,2009-11-13,The Boat That Rocked,50000000,8017467,37472651,-12527349,11,29455184,2009,-25.054698
1199,100,2004-01-30,The Big Bounce,50000000,6471394,6626115,-43373885,1,154721,2004,-86.74777
1200,1,2000-03-03,What Planet Are You From?,50000000,6291602,6291602,-43708398,3,0,2000,-87.41679599999999
1201,2,2015-04-17,Child 44,50000000,1224330,8004221,-41995779,4,6779891,2015,-83.991558
1202,3,2009-01-23,Outlander,50000000,166003,1250617,-48749383,1,1084614,2009,-97.498766
1203,4,2013-03-15,Upside Down,50000000,102118,26387039,-23612961,3,26284921,2013,-47.225922
1204,5,2015-10-02,Shanghai,50000000,46425,15505922,-34494078,10,15459497,2015,-68.988156
1205,6,2020-12-31,Hannibal the Conqueror,50000000,0,0,-50000000,12,0,2020,-100.0
1206,7,2019-11-08,Arctic Dogs,50000000,0,0,-50000000,11,0,2019,-100.0
1207,8,2019-11-22,The Rhythm Section,50000000,0,0,-50000000,11,0,2019,-100.0
1208,9,2019-09-20,Ad Astra,49800000,0,0,-49800000,9,0,2019,-100.0
1209,10,2001-11-02,The One,49000000,43905746,72689126,23689126,11,28783380,2001,48.34515510204081
1210,11,2015-03-06,Chappie,49000000,31569268,105002056,56002056,3,73432788,2015,114.28991020408164
1211,12,1990-07-11,The Adventures of Ford Fairlane,49000000,20423389,20423389,-28576611,7,0,1990,-58.31961428571428
1212,13,2012-11-16,Anna Karenina,49000000,12816367,71004627,22004627,11,58188260,2012,44.90740204081632
1213,14,1989-05-24,Indiana Jones and the Last Crusade,48000000,197171806,474171806,426171806,5,277000000,1989,887.8579291666666
1214,15,2002-10-18,The Ring,48000000,129094024,248218486,200218486,10,119124462,2002,417.12184583333334
1215,16,2000-12-27,Traffic,48000000,124107476,208300000,160300000,12,84192524,2000,333.9583333333333
1216,17,2002-03-29,Panic Room,48000000,95308367,196308367,148308367,3,101000000,2002,308.97576458333333
1217,18,2015-01-09,Taken 3,48000000,89256424,327656424,279656424,1,238400000,2015,582.6175499999999
1218,19,1999-08-06,The Thomas Crown Affair,48000000,69304264,124304264,76304264,8,55000000,1999,158.96721666666667
1219,20,2018-11-16,Instant Family,48000000,67363237,119736188,71736188,11,52372951,2018,149.45039166666666
1220,21,1999-11-05,The Bone Collector,48000000,66488090,151463090,103463090,11,84975000,1999,215.54810416666666
1221,22,1999-10-01,Three Kings,48000000,60652036,107752036,59752036,10,47100000,1999,124.48340833333333
1222,23,2010-01-22,Tooth Fairy,48000000,60022256,112610386,64610386,1,52588130,2010,134.60497083333334
1223,24,2001-08-17,Rat Race,48000000,56607223,86607223,38607223,8,30000000,2001,80.43171458333333
1224,25,2007-09-07,3:10 to Yuma,48000000,53606916,71171825,23171825,9,17564909,2007,48.27463541666667
1225,26,2001-08-13,K-PAX,48000000,50315140,50315140,2315140,8,0,2001,4.8232083333333335
1226,27,2001-12-25,Kate and Leopold,48000000,47095453,70937778,22937778,12,23842325,2001,47.787037500000004
1227,28,2000-10-20,Bedazzled,48000000,37879996,90376224,42376224,10,52496228,2000,88.2838
1228,29,1998-06-26,Out of Sight,48000000,37562568,77562568,29562568,6,40000000,1998,61.588683333333336
1229,30,1984-12-14,The Cotton Club,48000000,25928721,25928721,-22071279,12,0,1984,-45.98183125
1230,31,2008-01-25,Rambo,47500000,42754105,112214531,64714531,1,69460426,2008,136.24111789473685
1231,32,2016-07-13,The Infiltrator,47500000,15436808,20718104,-26781896,7,5281296,2016,-56.38293894736842
1232,33,1990-06-15,Dick Tracy,47000000,103738726,162738726,115738726,6,59000000,1990,246.25260851063828
1233,34,2016-11-11,Arrival,47000000,100546139,203127894,156127894,11,102581755,2016,332.1870085106383
1234,35,1996-06-14,The Cable Guy,47000000,60240295,102825796,55825796,6,42585501,1996,118.77828936170214
1235,36,2009-04-22,Earth,47000000,32011576,116773317,69773317,4,84761741,2009,148.4538659574468
1236,37,2001-10-19,Riding in Cars with Boys,47000000,29781453,29781453,-17218547,10,0,2001,-36.63520638297872
1237,38,2007-01-05,Happily N'Ever After,47000000,15849032,37923818,-9076182,1,22074786,2007,-19.311025531914893
1238,39,2002-11-27,Solaris,47000000,14970038,14970038,-32029962,11,0,2002,-68.14885531914894
1239,40,2010-06-18,Jonah Hex,47000000,10547117,11022696,-35977304,6,475579,2010,-76.54745531914894
1240,41,1996-02-23,Mary Reilly,47000000,5707094,12900000,-34100000,2,7192906,1996,-72.5531914893617
1241,42,2016-12-23,Silence,46500000,7100177,23726626,-22773374,12,16626449,2016,-48.97499784946236
1242,43,2013-11-01,Mr. Nobody,46500000,3622,22254,-46477746,11,18632,2013,-99.95214193548388
1243,44,1997-06-20,My Best Friend's Wedding,46000000,126813153,298923419,252923419,6,172110266,1997,549.8335195652173
1244,45,2001-07-20,America's Sweethearts,46000000,93607673,160648493,114648493,7,67040820,2001,249.2358543478261
1245,46,1996-11-22,Star Trek: First Contact,46000000,92027888,150000000,104000000,11,57972112,1996,226.08695652173913
1246,47,2002-05-24,Insomnia,46000000,67263182,113622499,67622499,5,46359317,2002,147.00543260869566
1247,48,2013-09-20,Prisoners,46000000,61002302,113402302,67402302,9,52400000,2013,146.52674347826087
1248,49,1996-07-12,Courage Under Fire,46000000,59003384,100833145,54833145,7,41829761,1996,119.20248913043478
1249,50,1982-09-17,Inchon,46000000,4408636,4408636,-41591364,9,0,1982,-90.41600869565217
1250,51,2010-12-31,Arthur and the War of Two Worlds,45500000,347136,36180824,-9319176,12,35833688,2010,-20.481705494505494
1251,52,1997-03-21,Liar Liar,45000000,181410615,302710615,257710615,3,121300000,1997,572.6902555555555
1252,53,1998-11-20,A Bug's Life,45000000,162798565,363095319,318095319,11,200296754,1998,706.8784866666666
1253,54,2012-10-05,Taken 2,45000000,139854287,377807404,332807404,10,237953117,2012,739.572008888889
1254,55,1994-05-27,The Flintstones,45000000,130531208,358500000,313500000,5,227968792,1994,696.6666666666666
1255,56,2003-10-24,Scary Movie 3,45000000,110000082,155200000,110200000,10,45199918,2003,244.88888888888889
1256,57,2000-12-22,Miss Congeniality,45000000,106807667,213420951,168420951,12,106613284,2000,374.26878
1257,58,2017-12-22,Pitch Perfect 3,45000000,104897530,185736412,140736412,12,80838882,2017,312.7475822222222
1258,59,2008-07-11,Journey to the Center of the Earth,45000000,101704370,243180937,198180937,7,141476567,2008,440.4020822222222
1259,60,1993-12-17,The Pelican Brief,45000000,100768056,187995859,142995859,12,87227803,1993,317.76857555555557
1260,61,2004-08-11,The Princess Diaries 2: Royal Engagement,45000000,95149435,122071435,77071435,8,26922000,2004,171.26985555555555
1261,62,2007-12-25,The Bucket List,45000000,93466502,174807445,129807445,12,81340943,2007,288.4609888888889
1262,63,1994-07-20,The Client,45000000,92115211,117615211,72615211,7,25500000,1994,161.36713555555556
1263,64,2011-11-23,The Muppets,45000000,88625922,160971922,115971922,11,72346000,2011,257.7153822222222
1264,65,1992-06-05,Patriot Games,45000000,83287363,178100000,133100000,6,94812637,1992,295.77777777777777
1265,66,2005-05-13,Monster-in-Law,45000000,82931301,155931301,110931301,5,73000000,2005,246.51400222222222
1266,67,2001-10-05,Training Day,45000000,76261036,104505362,59505362,10,28244326,2001,132.23413777777776
1267,68,2016-10-07,The Girl on the Train,45000000,75395035,174278214,129278214,10,98883179,2016,287.28492
1268,69,1999-12-24,Galaxy Quest,45000000,71423726,90523726,45523726,12,19100000,1999,101.16383555555555
1269,70,2001-07-04,Scary Movie 2,45000000,71277420,141189101,96189101,7,69911681,2001,213.7535577777778
1270,71,1998-08-21,Blade,45000000,70141876,131237688,86237688,8,61095812,1998,191.63930666666667
1271,72,2005-01-14,Coach Carter,45000000,67264877,76665507,31665507,1,9400630,2005,70.36779333333332
1272,73,2010-03-19,The Bounty Hunter,45000000,67061228,135808837,90808837,3,68747609,2010,201.79741555555557
1273,74,2002-04-12,Changing Lanes,45000000,66790248,66790248,21790248,4,0,2002,48.42277333333334
1274,75,1997-04-11,Anaconda,45000000,65598907,136998907,91998907,4,71400000,1997,204.44201555555557
1275,76,2006-01-20,Underworld: Evolution,45000000,62318875,113417762,68417762,1,51098887,2006,152.0394711111111
1276,77,2000-08-04,Coyote Ugly,45000000,60786269,113916474,68916474,8,53130205,2000,153.14772000000002
1277,78,2003-11-07,Love Actually,45000000,59472278,248505300,203505300,11,189033022,2003,452.234
1278,79,1996-08-09,Jack,45000000,58617334,58617334,13617334,8,0,1996,30.26074222222222
1279,80,1994-10-07,The Specialist,45000000,57362581,57362581,12362581,10,0,1994,27.472402222222218
1280,81,2016-12-09,Office Christmas Party,45000000,54767494,91323299,46323299,12,36555805,2016,102.94066444444445
1281,82,1996-08-16,Tin Cup,45000000,53854588,75854588,30854588,8,22000000,1996,68.56575111111111
1282,83,2005-11-23,"Yours, Mine and Ours",45000000,53359917,72359917,27359917,11,19000000,2005,60.79981555555556
1283,84,2005-05-13,Kicking and Screaming,45000000,52842724,55842724,10842724,5,3000000,2005,24.094942222222222
1284,85,2005-04-29,The Hitchhiker's Guide to the Galaxy,45000000,51019112,102746214,57746214,4,51727102,2005,128.32492
1285,86,2007-09-21,Resident Evil: Extinction,45000000,50648679,149871103,104871103,9,99222424,2007,233.04689555555558
1286,87,2004-12-25,Fat Albert,45000000,48114556,48563556,3563556,12,449000,2004,7.919013333333333
1287,88,2012-07-06,Savages,45000000,47323100,82513490,37513490,7,35190390,2012,83.36331111111112
1288,89,1994-09-30,The River Wild,45000000,46815000,94215000,49215000,9,47400000,1994,109.36666666666666
1289,90,2014-05-23,Blended,45000000,46290741,127990741,82990741,5,81700000,2014,184.42386888888888
1290,91,2017-06-16,All Eyez on Me,45000000,44922302,54876855,9876855,6,9954553,2017,21.948566666666665
1291,92,2006-01-13,Last Holiday,45000000,38399961,43343247,-1656753,1,4943286,2006,-3.681673333333333
1292,93,2006-03-03,16 Blocks,45000000,36895141,65595141,20595141,3,28700000,2006,45.766980000000004
1293,94,1995-07-14,The Indian in the Cupboard,45000000,35627222,35627222,-9372778,7,0,1995,-20.828395555555556
1294,95,2004-09-10,Cellular,45000000,32003620,61475984,16475984,9,29472364,2004,36.613297777777774
1295,96,2006-07-28,The Ant Bully,45000000,28142535,49610898,4610898,7,21468363,2006,10.24644
1296,97,2003-07-18,Johnny English,45000000,28013509,163126676,118126676,7,135113167,2003,262.50372444444446
1297,98,1984-12-14,Dune,45000000,27447471,27447471,-17552529,12,0,1984,-39.00562
1298,99,2009-07-31,Aliens in the Attic,45000000,25200412,59551283,14551283,7,34350871,2009,32.33618444444444
1299,100,2007-09-14,Across the Universe,45000000,24343673,29367143,-15632857,9,5023470,2007,-34.73968222222222
1300,1,2008-12-26,Revolutionary Road,45000000,22951340,79604820,34604820,12,56653480,2008,76.8996
1301,2,2008-08-29,Babylon A.D.,45000000,22532572,70216497,25216497,8,47683925,2008,56.036660000000005
1302,3,1994-11-04,Frankenstein,45000000,22006296,112006296,67006296,11,90000000,1994,148.90288
1303,4,1996-10-04,The Glimmer Man,45000000,20404841,36404841,-8595159,10,16000000,1996,-19.100353333333334
1304,5,1996-07-17,Multiplicity,45000000,20133326,20133326,-24866674,7,0,1996,-55.259275555555554
1305,6,2019-05-03,UglyDolls,45000000,19894664,24644664,-20355336,5,4750000,2019,-45.23408
1306,7,2001-01-19,The Pledge,45000000,19719930,29406132,-15593868,1,9686202,2001,-34.653040000000004
1307,8,2005-12-16,The Producers: The Movie Musical,45000000,19398532,32952995,-12047005,12,13554463,2005,-26.77112222222222
1308,9,1996-06-07,The Phantom,45000000,17220599,17220599,-27779401,6,0,1996,-61.73200222222223
1309,10,2005-07-01,Rebound,45000000,16809014,17492014,-27507986,7,683000,2005,-61.12885777777778
1310,11,2010-02-19,The Ghost Writer,45000000,15541549,65532491,20532491,2,49990942,2010,45.62775777777778
1311,12,2000-12-22,All the Pretty Horses,45000000,15527125,18120267,-26879733,12,2593142,2000,-59.73273999999999
1312,13,2008-09-05,Bangkok Dangerous,45000000,15298133,46598133,1598133,9,31300000,2008,3.5514066666666664
1313,14,1995-12-20,Nixon,45000000,13668249,34668249,-10331751,12,21000000,1995,-22.959446666666665
1314,15,2012-09-21,Dredd,45000000,13414714,41467606,-3532394,9,28052892,2012,-7.849764444444444
1315,16,2011-10-28,The Rum Diary,45000000,13109815,21544732,-23455268,10,8434917,2011,-52.122817777777776
1316,17,1998-01-30,Deep Rising,45000000,11203026,11203026,-33796974,1,0,1998,-75.10438666666667
1317,18,2018-12-21,Welcome to Marwen,45000000,10763520,12874922,-32125078,12,2111402,2018,-71.38906222222222
1318,19,2011-10-21,Johnny English Reborn,45000000,8406711,164640401,119640401,10,156233690,2011,265.8675577777778
1319,20,2008-09-26,Miracle at St. Anna,45000000,7916887,9676497,-35323503,9,1759610,2008,-78.49667333333333
1320,21,2002-04-05,Big Trouble,45000000,7262288,8488871,-36511129,4,1226583,2002,-81.13584222222222
1321,22,2006-12-21,Man cheng jin dai huang jin jia,45000000,6566773,76904429,31904429,12,70337656,2006,70.89873111111112
1322,23,2007-11-16,Love in the Time of Cholera,45000000,4617608,31077418,-13922582,11,26459810,2007,-30.93907111111111
1323,24,2002-12-25,Pinocchio,45000000,3681811,31681811,-13318189,12,28000000,2002,-29.595975555555555
1324,25,1997-01-31,Shadow Conspiracy,45000000,2154540,2154540,-42845460,1,0,1997,-95.21213333333334
1325,26,2012-12-31,Foodfight!,45000000,0,73706,-44926294,12,73706,2012,-99.83620888888889
1326,27,2012-10-12,Argo,44500000,136025503,227140757,182640757,10,91115254,2012,410.42866741573033
1327,28,1993-08-06,The Fugitive,44000000,183875760,353715317,309715317,8,169839557,1993,703.8984477272727
1328,29,1985-05-22,Rambo: First Blood Part II,44000000,150415432,300400000,256400000,5,149984568,1985,582.7272727272727
1329,30,1996-10-18,Sleepers,44000000,53300852,165600852,121600852,10,112300000,1996,276.3655727272727
1330,31,2010-07-30,Charlie St. Cloud,44000000,31206263,48478084,4478084,7,17271821,2010,10.177463636363635
1331,32,1996-02-02,The Juror,44000000,22730924,22730924,-21269076,2,0,1996,-48.33880909090909
1332,33,2014-02-06,The Interview,44000000,6105175,12342632,-31657368,2,6237457,2014,-71.94856363636364
1333,34,1980-11-19,Heaven's Gate,44000000,3484331,3484523,-40515477,11,192,1980,-92.08062954545456
1334,35,2013-06-28,The Heat,43000000,159581587,229727774,186727774,6,70146187,2013,434.25063720930234
1335,36,2000-12-19,Finding Forrester,43000000,51768623,80013623,37013623,12,28245000,2000,86.0781930232558
1336,37,2000-04-14,28 Days,43000000,37035515,62063972,19063972,4,25028457,2000,44.33481860465116
1337,38,2005-05-13,Danny the Dog,43000000,24537621,49037621,6037621,5,24500000,2005,14.040979069767442
1338,39,2002-04-12,The Sweetest Thing,43000000,24430272,63078756,20078756,4,38648484,2002,46.69478139534884
1339,40,2018-11-09,The Girl in the Spiderâs Web,43000000,14828555,34983342,-8016658,11,20154787,2018,-18.64339069767442
1340,41,2017-01-06,A Monster Calls,43000000,3740823,46414530,3414530,1,42673707,2017,7.940767441860465
1341,42,2011-01-28,The Mechanic,42500000,29121498,76347393,33847393,1,47225895,2011,79.64092470588236
1342,43,1993-06-30,The Firm,42000000,158340892,270340892,228340892,6,112000000,1993,543.6687904761905
1343,44,2012-03-16,21 Jump Street,42000000,138447667,202812429,160812429,3,64364762,2012,382.88673571428575
1344,45,1999-05-28,Notting Hill,42000000,116089678,363728085,321728085,5,247638407,1999,766.0192499999999
1345,46,2000-06-21,Chicken Run,42000000,106793915,227793915,185793915,6,121000000,2000,442.3664642857143
1346,47,2004-01-16,Along Came Polly,42000000,88073507,173044410,131044410,1,84970903,2004,312.01050000000004
1347,48,1992-07-01,Boomerang,42000000,70052444,131052444,89052444,7,61000000,1992,212.0296285714286
1348,49,2009-07-10,BrÃ¼no,42000000,60054530,138708527,96708527,7,78653997,2009,230.25839761904763
1349,50,1963-06-12,Cleopatra,42000000,57000000,71000000,29000000,6,14000000,1963,69.04761904761905
1350,51,2017-05-12,Snatched,42000000,45852178,57852177,15852177,5,11999999,2017,37.743278571428576
1351,52,2012-10-12,Here Comes the Boom,42000000,45290318,73239258,31239258,10,27948940,2012,74.37918571428571
1352,53,2002-04-05,High Crimes,42000000,41543207,63781100,21781100,4,22237893,2002,51.8597619047619
1353,54,1996-11-15,The Mirror Has Two Faces,42000000,41267469,41267469,-732531,11,0,1996,-1.7441214285714286
1354,55,2011-03-11,Red Riding Hood,42000000,37662162,91678442,49678442,3,54016280,2011,118.28200476190476
1355,56,2002-01-25,The Mothman Prophecies,42000000,35228696,56438555,14438555,1,21209859,2002,34.3775119047619
1356,57,1989-07-14,Licence to Kill,42000000,34667015,156167015,114167015,7,121500000,1989,271.8262261904762
1357,58,2018-12-25,Holmes & Watson,42000000,30568743,41926605,-73395,12,11357862,2018,-0.17475
1358,59,2012-01-27,One for the Money,42000000,26414527,36197221,-5802779,1,9782694,2012,-13.816140476190474
1359,60,2001-03-09,15 Minutes,42000000,24375436,56331864,14331864,3,31956428,2001,34.123485714285714
1360,61,2005-09-16,Lord of War,42000000,24149632,60437727,18437727,9,36288095,2005,43.89935
1361,62,1993-05-28,Super Mario Bros.,42000000,20844907,20844907,-21155093,5,0,1993,-50.36926904761905
1362,63,1992-10-02,Hero,42000000,19487173,66787173,24787173,10,47300000,1992,59.01707857142857
1363,64,2012-01-27,Man on a Ledge,42000000,18620000,49621440,7621440,1,31001440,2012,18.146285714285714
1364,65,2010-12-03,The Warrior's Way,42000000,5666340,8514325,-33485675,12,2847985,2010,-79.72779761904762
1365,66,1997-04-18,McHale's Navy,42000000,4408420,4408420,-37591580,4,0,1997,-89.5037619047619
1366,67,2010-05-28,Micmacs,42000000,1259693,11756922,-30243078,5,10497229,2010,-72.00732857142857
1367,68,2006-12-31,Les BronzÃ©s 3: amis pour la vie,42000000,0,83833602,41833602,12,83833602,2006,99.6038142857143
1368,69,2015-12-31,Pourquoi j'ai pas mangÃ© mon pÃ¨re,42000000,0,15451663,-26548337,12,15451663,2015,-63.210326190476195
1369,70,2002-11-08,8 Mile,41000000,116724075,245768384,204768384,11,129044309,2002,499.4350829268293
1370,71,2019-05-31,Rocketman,41000000,57342725,108642725,67642725,5,51300000,2019,164.982256097561
1371,72,2001-05-11,A Knightâs Tale,41000000,56083966,100622586,59622586,5,44538620,2001,145.42094146341464
1372,73,2003-08-22,The Medallion,41000000,22108977,22108977,-18891023,8,0,2003,-46.075665853658535
1373,74,2011-10-14,The Big Year,41000000,7204138,7684524,-33315476,10,480386,2011,-81.25725853658537
1374,75,1999-08-06,The Sixth Sense,40000000,293506292,672806292,632806292,8,379300000,1999,1582.01573
1375,76,2005-07-15,Wedding Crashers,40000000,209218368,283218368,243218368,7,74000000,2005,608.04592
1376,77,2010-06-11,The Karate Kid,40000000,176591618,351774938,311774938,6,175183320,2010,779.437345
1377,78,2015-02-13,Fifty Shades of Grey,40000000,166167230,570998101,530998101,2,404830871,2015,1327.4952524999999
1378,79,2009-06-19,The Proposal,40000000,163958031,314709717,274709717,6,150751686,2009,686.7742925
1379,80,2013-12-13,American Hustle,40000000,150117807,257878294,217878294,12,107760487,2013,544.695735
1380,81,2019-05-17,John Wick: Chapter 3 â Parabellum,40000000,141744320,256498033,216498033,5,114753713,2019,541.2450825
1381,82,2003-12-25,Cheaper by the Dozen,40000000,138614544,190212113,150212113,12,51597569,2003,375.5302825
1382,83,2014-07-25,Lucy,40000000,126573960,457507776,417507776,7,330933816,2014,1043.76944
1383,84,2013-12-25,Lone Survivor,40000000,125095601,149804632,109804632,12,24709031,2013,274.51158000000004
1384,85,1989-11-22,Back to the Future Part II,40000000,118450002,332000000,292000000,11,213549998,1989,730.0
1385,86,1999-09-24,Double Jeopardy,40000000,116735231,177835231,137835231,9,61100000,1999,344.5880775
1386,87,2003-07-25,Spy Kids 3-D: Game Over,40000000,111760631,167851995,127851995,7,56091364,2003,319.62998749999997
1387,88,1996-07-24,A Time to Kill,40000000,108766007,152266007,112266007,7,43500000,1996,280.66501750000003
1388,89,1992-07-01,A League of Their Own,40000000,107533925,132440066,92440066,7,24906141,1992,231.100165
1389,90,2016-06-10,The Conjuring 2: The Enfield Poltergeist,40000000,102470008,311262102,271262102,6,208792094,2016,678.155255
1390,91,2010-10-01,The Social Network,40000000,96962694,224922135,184922135,10,127959441,2010,462.30533749999995
1391,92,2009-08-07,Julie & Julia,40000000,94125426,126646119,86646119,8,32520693,2009,216.61529750000003
1392,93,2009-02-06,He's Just Not That Into You,40000000,93953653,181053657,141053657,2,87100004,2009,352.6341425
1393,94,2017-02-10,John Wick: Chapter Two,40000000,92029184,171350009,131350009,2,79320825,2017,328.3750225
1394,95,2016-01-15,Ride Along 2,40000000,90862685,124827316,84827316,1,33964631,2016,212.06829
1395,96,2006-04-14,Scary Movie 4,40000000,90710620,178710620,138710620,4,88000000,2006,346.77655
1396,97,2015-03-27,Get Hard,40000000,90411453,106511453,66511453,3,16100000,2015,166.2786325
1397,98,2000-02-04,Scream 3,40000000,89138076,161838076,121838076,2,72700000,2000,304.59519
1398,99,1990-05-24,Back to the Future Part III,40000000,88055283,244088654,204088654,5,156033371,1990,510.221635
1399,100,2016-10-14,The Accountant,40000000,86260045,152962083,112962083,10,66702038,2016,282.4052075
1400,1,2014-11-14,Dumb and Dumber To,40000000,86208010,156553592,116553592,11,70345582,2014,291.38398
1401,2,2014-04-25,The Other Woman,40000000,83911193,195111193,155111193,4,111200000,2014,387.7779825
1402,3,1992-11-13,Bram Stoker's Dracula,40000000,82522790,215862692,175862692,11,133339902,1992,439.65673
1403,4,2006-02-17,Eight Below,40000000,81612565,120455994,80455994,2,38843429,2006,201.13998500000002
1404,5,1999-12-24,The Talented Mr. Ripley,40000000,81292135,128792135,88792135,12,47500000,1999,221.98033750000002
1405,6,2015-09-25,The Intern,40000000,75764672,197115710,157115710,9,121351038,2015,392.789275
1406,7,1992-09-25,The Last of the Mohicans,40000000,75505856,75505856,35505856,9,0,1992,88.76464
1407,8,2004-10-29,Ray,40000000,75305995,124823094,84823094,10,49517099,2004,212.057735
1408,9,2005-04-01,Sin City,40000000,74103820,158527918,118527918,4,84424098,2005,296.319795
1409,10,2015-10-16,Bridge of Spies,40000000,72313754,162498338,122498338,10,90184584,2015,306.245845
1410,11,2008-02-22,Vantage Point,40000000,72266306,150886329,110886329,2,78620023,2008,277.2158225
1411,12,2009-03-20,"I Love You, Man",40000000,72013010,92302502,52302502,3,20289492,2009,130.756255
1412,13,2001-11-09,Shallow Hal,40000000,70836296,70836296,30836296,11,0,2001,77.09074
1413,14,1991-12-20,JFK,40000000,70405498,205400000,165400000,12,134994502,1991,413.5
1414,15,2006-01-27,Big Momma's House 2,40000000,70165972,137047376,97047376,1,66881404,2006,242.61844
1415,16,2018-09-21,The House with a Clock in its Walls,40000000,68549695,126331750,86331750,9,57782055,2018,215.829375
1416,17,2016-11-04,Hacksaw Ridge,40000000,67209615,168904682,128904682,11,101695067,2016,322.261705
1417,18,2001-03-02,The Mexican,40000000,66808615,145238250,105238250,3,78429635,2001,263.095625
1418,19,2009-08-28,The Final Destination,40000000,66477700,187384627,147384627,8,120906927,2009,368.4615675
1419,20,2009-04-17,17 Again,40000000,64167069,139474906,99474906,4,75307837,2009,248.687265
1420,21,2011-02-18,Unknown,40000000,63686397,136123083,96123083,2,72436686,2011,240.30770750000002
1421,22,2010-06-04,Get Him to the Greek,40000000,61153526,91455875,51455875,6,30302349,2010,128.6396875
1422,23,2003-11-21,Gothika,40000000,59588068,141484812,101484812,11,81896744,2003,253.71203000000003
1423,24,2001-11-30,Behind Enemy Lines,40000000,58855732,58855732,18855732,11,0,2001,47.13933
1424,25,2011-03-18,The Lincoln Lawyer,40000000,58009200,87145086,47145086,3,29135886,2011,117.86271500000001
1425,26,2004-10-15,Shall We Dance?,40000000,57887882,118097882,78097882,10,60210000,2004,195.244705
1426,27,2006-08-25,Invincible,40000000,57806952,58501127,18501127,8,694175,2006,46.2528175
1427,28,2013-02-15,Escape From Planet Earth,40000000,57012977,74156610,34156610,2,17143633,2013,85.391525
1428,29,1998-07-10,Small Soldiers,40000000,55143823,71743823,31743823,7,16600000,1998,79.3595575
1429,30,1997-07-31,Spawn,40000000,54979992,87949859,47949859,7,32969867,1997,119.87464750000001
1430,31,2014-11-26,Horrible Bosses 2,40000000,54445357,105945357,65945357,11,51500000,2014,164.8633925
1431,32,2002-01-25,The Count of Monte Cristo,40000000,54228104,75389090,35389090,1,21160986,2002,88.472725
1432,33,2006-10-20,The Prestige,40000000,53089891,104407366,64407366,10,51317475,2006,161.018415
1433,34,2006-06-16,The Lake House,40000000,52330111,114830111,74830111,6,62500000,2006,187.0752775
1434,35,2010-07-09,Predators,40000000,52000688,127234389,87234389,7,75233701,2010,218.0859725
1435,36,2012-08-15,The Odd Life of Timothy Green,40000000,51853450,55249159,15249159,8,3395709,2012,38.1228975
1436,37,1987-07-31,The Living Daylights,40000000,51185000,191200000,151200000,7,140015000,1987,378.0
1437,38,2006-12-08,Apocalypto,40000000,50866635,121032272,81032272,12,70165637,2006,202.58067999999997
1438,39,2007-02-14,Music and Lyrics,40000000,50572589,146196885,106196885,2,95624296,2007,265.4922125
1439,40,1986-06-18,Legal Eagles,40000000,49851591,49851591,9851591,6,0,1986,24.628977499999998
1440,41,2004-03-12,Secret Window,40000000,47958031,92111551,52111551,3,44153520,2004,130.2788775
1441,42,2005-08-12,The Skeleton Key,40000000,47907715,92256918,52256918,8,44349203,2005,130.642295
1442,43,2014-06-20,Jersey Boys,40000000,47047013,65282732,25282732,6,18235719,2014,63.206830000000004
1443,44,2008-05-02,Made of Honor,40000000,46012734,106548738,66548738,5,60536004,2008,166.371845
1444,45,1997-11-21,The Rainmaker,40000000,45916769,45916769,5916769,11,0,1997,14.791922499999998
1445,46,1992-02-07,Medicine Man,40000000,44948240,44948240,4948240,2,0,1992,12.3706
1446,47,1997-12-12,Amistad,40000000,44212592,58250151,18250151,12,14037559,1997,45.6253775
1447,48,2014-05-30,A Million Ways to Die in The West,40000000,42720965,86778557,46778557,5,44057592,2014,116.9463925
1448,49,2011-08-12,Final Destination 5,40000000,42587643,155011165,115011165,8,112423522,2011,287.5279125
1449,50,2018-11-16,Widows,40000000,42402632,73866088,33866088,11,31463456,2018,84.66521999999999
1450,51,2005-04-08,Fever Pitch,40000000,42071069,50071069,10071069,4,8000000,2005,25.177672499999996
1451,52,2007-12-25,Aliens vs. Predator - Requiem,40000000,41797066,128884494,88884494,12,87087428,2007,222.21123500000002
1452,53,2007-12-25,The Water Horse: Legend of the Deep,40000000,40412817,103429755,63429755,12,63016938,2007,158.5743875
1453,54,2014-07-18,Sex Tape,40000000,38543473,126069509,86069509,7,87526036,2014,215.17377249999998
1454,55,2011-04-15,Scream 4,40000000,38180928,95989590,55989590,4,57808662,2011,139.973975
1455,56,1994-12-21,Ri¢hie Ri¢h,40000000,38087756,38087756,-1912244,12,0,1994,-4.780609999999999
1456,57,2000-08-11,Autumn in New York,40000000,37752931,90717684,50717684,8,52964753,2000,126.79420999999999
1457,58,2011-03-18,Paul,40000000,37412945,101162106,61162106,3,63749161,2011,152.90526499999999
1458,59,2012-12-19,The Guilt Trip,40000000,37134215,41294674,1294674,12,4160459,2012,3.2366850000000005
1459,60,2011-08-26,Colombiana,40000000,36665854,72295262,32295262,8,35629408,2011,80.738155
1460,61,1999-02-26,8MM,40000000,36443442,96398826,56398826,2,59955384,1999,140.997065
1461,62,2018-01-12,The Commuter,40000000,36343858,101985431,61985431,1,65641573,2018,154.9635775
1462,63,2000-02-18,Hanging Up,40000000,36037909,51867723,11867723,2,15829814,2000,29.6693075
1463,64,1991-03-01,The Doors,40000000,34416893,34416893,-5583107,3,0,1991,-13.957767500000001
1464,65,1999-08-20,Mickey Blue Eyes,40000000,33864342,53864342,13864342,8,20000000,1999,34.660855
1465,66,2000-10-20,Pay it Forward,40000000,33508922,55696705,15696705,10,22187783,2000,39.2417625
1466,67,2011-04-08,Arthur,40000000,33035397,47787943,7787943,4,14752546,2011,19.4698575
1467,68,2008-03-21,Drillbit Taylor,40000000,32862104,49686263,9686263,3,16824159,2008,24.215657500000002
1468,69,2016-12-21,Patriots Day,40000000,31886361,52837989,12837989,12,20951628,2016,32.094972500000004
1469,70,2011-12-25,Extremely Loud and Incredibly Close,40000000,31847881,55247881,15247881,12,23400000,2011,38.1197025
1470,71,1994-07-01,The Shadow,40000000,31835600,31835600,-8164400,7,0,1994,-20.411
1471,72,2008-11-26,Transporter 3,40000000,31715062,107235592,67235592,11,75520530,2008,168.08898000000002
1472,73,2010-11-10,Morning Glory,40000000,31011732,59795070,19795070,11,28783338,2010,49.487674999999996
1473,74,2005-11-09,Get Rich or Die Tryin',40000000,30981850,46666955,6666955,11,15685105,2005,16.6673875
1474,75,2019-05-03,Long Shot,40000000,30202860,43711031,3711031,5,13508171,2019,9.2775775
1475,76,2000-08-25,The Art of War,40000000,30199105,30199105,-9800895,8,0,2000,-24.5022375
1476,77,2013-12-25,Grudge Match,40000000,29807260,69807260,29807260,12,40000000,2013,74.51815
1477,78,2000-08-11,Bless the Child,40000000,29374178,40435694,435694,8,11061516,2000,1.089235
1478,79,2005-11-23,Rent,40000000,29077547,31670620,-8329380,11,2593073,2005,-20.823449999999998
1479,80,1999-04-02,The Out-of-Towners,40000000,28544120,28544120,-11455880,4,0,1999,-28.6397
1480,81,2017-08-11,The Nut Job 2: Nutty by Nature,40000000,28370522,57438389,17438389,8,29067867,2017,43.5959725
1481,82,1996-08-23,The Island of Dr. Moreau,40000000,27682712,27682712,-12317288,8,0,1996,-30.793219999999998
1482,83,2001-09-07,The Musketeer,40000000,27053815,27053815,-12946185,9,0,2001,-32.3654625
1483,84,2017-01-27,Resident Evil: The Final Chapter,40000000,26844692,314101190,274101190,1,287256498,2017,685.252975
1484,85,2008-02-29,The Other Boleyn Girl,40000000,26814957,78269970,38269970,2,51455013,2008,95.674925
1485,86,2017-06-30,The House,40000000,25584504,31192425,-8807575,6,5607921,2017,-22.0189375
1486,87,2001-02-16,Sweet November,40000000,25288103,65754228,25754228,2,40466125,2001,64.38557
1487,88,2007-04-05,The Reaping,40000000,25126214,62226214,22226214,4,37100000,2007,55.565535
1488,89,2011-01-07,Season of the Witch,40000000,24827228,91126600,51126600,1,66299372,2011,127.8165
1489,90,1994-06-03,Renaissance Man,40000000,24172899,24172899,-15827101,6,0,1994,-39.5677525
1490,91,1998-05-15,Quest for Camelot,40000000,22772500,38172500,-1827500,5,15400000,1998,-4.56875
1491,92,2002-09-06,City by the Sea,40000000,22433915,22433915,-17566085,9,0,2002,-43.9152125
1492,93,1999-01-15,At First Sight,40000000,22365133,22365133,-17634867,1,0,1999,-44.0871675
1493,94,2016-08-26,Mechanic: Resurrection,40000000,21218403,109738840,69738840,8,88520437,2016,174.3471
1494,95,2004-01-16,Torque,40000000,21176322,46176322,6176322,1,25000000,2004,15.440805
1495,96,2009-11-13,Fantastic Mr. Fox,40000000,21002919,47083412,7083412,11,26080493,2009,17.70853
1496,97,1995-09-22,Showgirls,40000000,20350754,37750754,-2249246,9,17400000,1995,-5.623115
1497,98,1996-02-16,City Hall,40000000,20278055,20278055,-19721945,2,0,1996,-49.3048625
1498,99,2012-02-03,Big Miracle,40000000,20157300,25268680,-14731320,2,5111380,2012,-36.828300000000006
1499,100,2012-12-21,The Impossible,40000000,19019882,169590606,129590606,12,150570724,2012,323.976515
1500,1,2012-03-09,A Thousand Words,40000000,18450127,20790486,-19209514,3,2340359,2012,-48.023785000000004
1501,2,2006-10-20,Marie Antoinette,40000000,15962471,60862471,20862471,10,44900000,2006,52.1561775
1502,3,2000-10-06,Get Carter,40000000,14967182,19417182,-20582818,10,4450000,2000,-51.457045
1503,4,1995-04-21,Kiss of Death,40000000,14942422,14942422,-25057578,4,0,1995,-62.643945
1504,5,2002-04-26,"Life, or Something Like It",40000000,14448589,14448589,-25551411,4,0,2002,-63.878527500000004
1505,6,1987-05-15,Ishtar,40000000,14375181,14375181,-25624819,5,0,1987,-64.06204749999999
1506,7,1992-02-28,Memoirs of an Invisible Man,40000000,14358033,14358033,-25641967,2,0,1992,-64.1049175
1507,8,2009-10-23,Amelia,40000000,14279575,19756077,-20243923,10,5476502,2009,-50.6098075
1508,9,2009-10-23,Cirque du Freak: The Vampire's Assistant,40000000,14046595,39753957,-246043,10,25707362,2009,-0.6151075
1509,10,2004-05-07,New York Minute,40000000,14018364,21215882,-18784118,5,7197518,2004,-46.960295
1510,11,1999-03-12,The Deep End of the Ocean,40000000,13508635,13508635,-26491365,3,0,1999,-66.2284125
1511,12,2004-11-05,Alfie,40000000,13395939,35195939,-4804061,11,21800000,2004,-12.0101525
1512,13,2002-08-30,FearDotCom,40000000,13208023,13208023,-26791977,8,0,2002,-66.9799425
1513,14,2008-11-07,Soul Men,40000000,12082391,12345883,-27654117,11,263492,2008,-69.1352925
1514,15,2015-03-20,The Gunman,40000000,10664749,18594227,-21405773,3,7929478,2015,-53.5144325
1515,16,1999-08-20,Universal Soldier II: The Return,40000000,10447421,10717421,-29282579,8,270000,1999,-73.20644750000001
1516,17,2009-09-25,Pandorum,40000000,10330853,17033431,-22966569,9,6702578,2009,-57.416422499999996
1517,18,2003-09-26,Duplex,40000000,9652000,10070651,-29929349,9,418651,2003,-74.82337249999999
1518,19,2013-08-16,Paranoia,40000000,7388654,16340767,-23659233,8,8952113,2013,-59.1480825
1519,20,1980-08-01,Raise the Titanic,40000000,7000000,7000000,-33000000,8,0,1980,-82.5
1520,21,2015-07-10,Baahubali: The Beginning,40000000,6738000,26736665,-13263335,7,19998665,2015,-33.1583375
1521,22,2018-03-09,The Hurricane Heist,40000000,6115824,30963684,-9036316,3,24847860,2018,-22.59079
1522,23,2002-01-04,Impostor,40000000,6114237,7974607,-32025393,1,1860370,2002,-80.0634825
1523,24,2015-11-25,Victor Frankenstein,40000000,5775076,31124367,-8875633,11,25349291,2015,-22.1890825
1524,25,2002-11-27,Extreme Ops,40000000,4835968,12624471,-27375529,11,7788503,2002,-68.4388225
1525,26,2001-04-06,Just Visiting,40000000,4777007,16172200,-23827800,4,11395193,2001,-59.5695
1526,27,2014-06-27,Snowpiercer,40000000,4563029,88069880,48069880,6,83506851,2014,120.17469999999999
1527,28,2007-07-20,Sunshine,40000000,3688560,32030610,-7969390,7,28342050,2007,-19.923475
1528,29,1994-03-11,The Hudsucker Proxy,40000000,2816518,14938149,-25061851,3,12121631,1994,-62.654627500000004
1529,30,2016-11-11,Billy Lynnâs Long Halftime Walk,40000000,1738477,30230402,-9769598,11,28491925,2016,-24.423995
1530,31,1986-07-01,Pirates,40000000,1641825,6341825,-33658175,7,4700000,1986,-84.1454375
1531,32,2008-12-12,Delgo,40000000,915840,915840,-39084160,12,0,2008,-97.71039999999999
1532,33,2007-09-07,The Hunting Party,40000000,876671,7729552,-32270448,9,6852881,2007,-80.67612
1533,34,2006-10-13,Alex Rider: Operation Stormbreaker,40000000,659210,20722450,-19277550,10,20063240,2006,-48.193875000000006
1534,35,2009-11-20,Red Cliff,40000000,627047,119627047,79627047,11,119000000,2009,199.06761749999998
1535,36,2004-09-24,The Last Shot,40000000,463730,463730,-39536270,9,0,2004,-98.840675
1536,37,2007-03-16,Nomad,40000000,79123,79123,-39920877,3,0,2007,-99.8021925
1537,38,2013-04-16,Un monstre Ã Paris,40000000,0,27000381,-12999619,4,27000381,2013,-32.4990475
1538,39,2019-06-21,Kursk,40000000,0,4212799,-35787201,6,4212799,2019,-89.4680025
1539,40,2016-11-11,USS Indianapolis: Men of Courage,40000000,0,1663785,-38336215,11,1663785,2016,-95.8405375
1540,41,2014-12-31,Dragon Nest Warriors' Dawn,40000000,0,734423,-39265577,12,734423,2014,-98.1639425
1541,42,2018-12-31,The Crow,40000000,0,0,-40000000,12,0,2018,-100.0
1542,43,2019-09-13,The Goldfinch,40000000,0,0,-40000000,9,0,2019,-100.0
1543,44,2019-12-31,Down Under Cover,40000000,0,0,-40000000,12,0,2019,-100.0
1544,45,2009-08-14,The Time Traveler's Wife,39000000,63414846,102332135,63332135,8,38917289,2009,162.39008974358975
1545,46,1983-06-17,Superman III,39000000,59950623,59950623,20950623,6,0,1983,53.71954615384615
1546,47,2007-02-02,Because I Said So,39000000,42674040,69538833,30538833,2,26864793,2007,78.30470000000001
1547,48,2012-10-05,Frankenweenie,39000000,35287788,81150788,42150788,10,45863000,2012,108.07894358974359
1548,49,1996-03-29,Sgt. Bilko,39000000,30356589,37956589,-1043411,3,7600000,1996,-2.6754128205128205
1549,50,2005-09-30,Serenity,39000000,25514517,40319440,1319440,9,14804923,2005,3.383179487179487
1550,51,2007-09-07,Shoot 'Em Up,39000000,12796824,26796824,-12203176,9,14000000,2007,-31.290194871794874
1551,52,2004-02-20,Against the Ropes,39000000,5881504,6429865,-32570135,2,548361,2004,-83.51316666666668
1552,53,2013-08-23,Yi dai zong shi,38600000,6594959,57987299,19387299,8,51392340,2013,50.22616321243524
1553,54,2001-06-22,The Fast and the Furious,38000000,144512310,206512310,168512310,6,62000000,2001,443.45344736842105
1554,55,2002-09-27,Sweet Home Alabama,38000000,127214072,182365114,144365114,9,55151042,2002,379.9081947368421
1555,56,2009-07-24,The Ugly Truth,38000000,88915214,205298907,167298907,7,116383693,2009,440.2602815789474
1556,57,2002-08-07,Spy Kids 2: The Island of Lost Dreams,38000000,85846296,119721296,81721296,8,33875000,2002,215.05604210526315
1557,58,1994-11-18,Star Trek: Generations,38000000,75671262,120000000,82000000,11,44328738,1994,215.78947368421052
1558,59,2017-06-02,Captain Underpants: The First Epic Movie,38000000,73921000,126577874,88577874,6,52656874,2017,233.09966842105263
1559,60,2015-04-17,Paul Blart: Mall Cop 2,38000000,71091594,107650646,69650646,4,36559052,2015,183.29117368421052
1560,61,1997-12-19,Mouse Hunt,38000000,61894591,61894591,23894591,12,0,1997,62.88050263157895
1561,62,2016-12-23,Why Him?,38000000,60323786,117425156,79425156,12,57101370,2016,209.01356842105264
1562,63,2011-04-22,Water for Elephants,38000000,58709717,116809717,78809717,4,58100000,2011,207.39399210526318
1563,64,2010-10-08,Life as We Know It,38000000,53374681,105887837,67887837,10,52513156,2010,178.65220263157894
1564,65,1999-12-29,The Hurricane,38000000,50699241,73956241,35956241,12,23257000,1999,94.62168684210526
1565,66,2013-09-06,Riddick,38000000,42025135,94763758,56763758,9,52738623,2013,149.37831052631577
1566,67,2001-03-23,Heartbreakers,38000000,40334024,57753825,19753825,3,17419801,2001,51.98374999999999
1567,68,2002-05-24,Enough,38000000,39177215,50970660,12970660,5,11793445,2002,34.133315789473684
1568,69,2016-01-22,The 5th Wave,38000000,34912982,111336398,73336398,1,76423416,2016,192.99052105263158
1569,70,2009-02-06,Push,38000000,31811527,49678401,11678401,2,17866874,2009,30.732634210526317
1570,71,2013-09-20,Rush,38000000,26947624,98230839,60230839,9,71283215,2013,158.50220789473684
1571,72,2001-05-18,Angel Eyes,38000000,24044532,29544532,-8455468,5,5500000,2001,-22.25123157894737
1572,73,2001-12-21,Joe Somebody,38000000,22770864,24515990,-13484010,12,1745126,2001,-35.48423684210527
1573,74,2000-03-10,The Ninth Gate,38000000,18653746,58394308,20394308,3,39740562,2000,53.669231578947375
1574,75,2017-10-20,Only the Brave,38000000,18340051,24555177,-13444823,10,6215126,2017,-35.38111315789474
1575,76,1996-09-27,Extreme Measures,38000000,17378193,17378193,-20621807,9,0,1996,-54.26791315789473
1576,77,2011-10-14,The Thing,38000000,16999934,27573078,-10426922,10,10573144,2011,-27.43926842105263
1577,78,2001-09-07,Rock Star,38000000,16991902,19317765,-18682235,9,2325863,2001,-49.16377631578948
1578,79,1996-02-02,White Squall,38000000,10229300,10229300,-27770700,2,0,1996,-73.08078947368422
1579,80,2008-10-10,City of Ember,38000000,7873007,17831558,-20168442,10,9958551,2008,-53.074847368421054
1580,81,1997-10-31,Switchback,38000000,6504442,6504442,-31495558,10,0,1997,-82.88304736842105
1581,82,2018-09-21,The Sisters Brothers,38000000,3143056,13143056,-24856944,9,10000000,2018,-65.41301052631579
1582,83,2001-11-30,Texas Rangers,38000000,623374,623374,-37376626,11,0,2001,-98.35954210526316
1583,84,2008-08-26,Virgin Territory,38000000,0,5473041,-32526959,8,5473041,2008,-85.5972605263158
1584,85,2019-01-11,The Upside,37500000,108235497,119024536,81524536,1,10789039,2019,217.39876266666664
1585,86,2012-05-18,What to Expect When You're Expecting,37500000,41152203,88473016,50973016,5,47320813,2012,135.92804266666667
1586,87,2012-09-14,The Master,37500000,16247159,50647416,13147416,9,34400257,2012,35.059776
1587,88,2008-10-10,The Express,37500000,9793406,9813309,-27686691,10,19903,2008,-73.831176
1588,89,2008-11-21,Twilight,37000000,192769854,402280159,365280159,11,209510305,2008,987.243672972973
1589,90,2013-08-07,We're the Millers,37000000,150394119,267816276,230816276,8,117422157,2013,623.827772972973
1590,91,2015-11-25,Creed,37000000,109767581,173567581,136567581,11,63800000,2015,369.10157027027026
1591,92,2010-09-17,The Town,37000000,92186262,152566881,115566881,9,60380619,2010,312.3429216216216
1592,93,2011-09-23,Dolphin Tale,37000000,72286779,96068724,59068724,9,23781945,2011,159.6452
1593,94,2018-02-23,Game Night,37000000,69179066,117378084,80378084,2,48199018,2018,217.23806486486487
1594,95,2008-09-12,Burn After Reading,37000000,60355347,168167798,131167798,9,107812451,2008,354.5075621621622
1595,96,2004-04-23,13 Going On 30,37000000,57139723,97658712,60658712,4,40518989,2004,163.94246486486486
1596,97,2008-04-04,Nim's Island,37000000,48006762,101857425,64857425,4,53850663,2008,175.29033783783782
1597,98,2016-02-12,How to be Single,37000000,46843513,100003780,63003780,2,53160267,2016,170.2804864864865
1598,99,2010-02-26,Cop Out,37000000,44875481,55909910,18909910,2,11034429,2010,51.10786486486486
1599,100,2011-01-28,The Rite,37000000,33047633,97143987,60143987,1,64096354,2011,162.5513162162162
1600,1,2008-07-18,Space Chimps,37000000,30105968,67029956,30029956,7,36923988,2008,81.16204324324325
1601,2,1999-12-17,Magnolia,37000000,22450975,48446802,11446802,12,25995827,1999,30.937302702702702
1602,3,2015-05-29,Aloha,37000000,21052030,25387091,-11612909,5,4335061,2015,-31.386240540540538
1603,4,2009-12-31,Obitaemyy ostrov,36500000,0,15000000,-21500000,12,15000000,2009,-58.9041095890411
1604,5,2018-10-05,A Star is Born,36000000,215288866,433449571,397449571,10,218160705,2018,1104.026586111111
1605,6,2011-02-11,Gnomeo and Juliet,36000000,99967670,193737977,157737977,2,93770307,2011,438.16104722222224
1606,7,2002-02-15,John Q,36000000,71026631,102226631,66226631,2,31200000,2002,183.9628638888889
1607,8,1999-09-17,Blue Streak,36000000,68208190,117448157,81448157,9,49239967,1999,226.24488055555557
1608,9,1983-10-07,Never Say Never Again,36000000,55500000,160000000,124000000,10,104500000,1983,344.44444444444446
1609,10,2010-03-26,Hot Tub Time Machine,36000000,50269859,65967750,29967750,3,15697891,2010,83.24375
1610,11,1997-05-02,Breakdown,36000000,50159144,50159144,14159144,5,0,1997,39.330955555555555
1611,12,2014-09-12,Dolphin Tale 2,36000000,42024533,57824533,21824533,9,15800000,2014,60.62370277777778
1612,13,2016-12-16,Collateral Beauty,36000000,31016021,85309093,49309093,12,54293072,2016,136.96970277777777
1613,14,2003-04-04,A Man Apart,36000000,26500000,43797731,7797731,4,17297731,2003,21.660363888888888
1614,15,2000-02-25,Reindeer Games,36000000,23360779,23360779,-12639221,2,0,2000,-35.10894722222222
1615,16,1999-12-24,Snow Falling on Cedars,36000000,14378353,14378353,-21621647,12,0,1999,-60.06013055555556
1616,17,1996-12-20,Ghosts of Mississippi,36000000,13052741,13052741,-22947259,12,0,1996,-63.74238611111112
1617,18,1997-10-24,Gattaca,36000000,12532777,12532777,-23467223,10,0,1997,-65.18673055555556
1618,19,2000-01-28,Isn't She Great,36000000,2954405,2954405,-33045595,1,0,2000,-91.79331944444445
1619,20,2016-01-22,Yip Man 3,36000000,2679437,157300954,121300954,1,154621517,2016,336.9470944444445
1620,21,2011-05-06,There Be Dragons,36000000,1069334,4020990,-31979010,5,2951656,2011,-88.83058333333334
1621,22,2017-04-14,Queen of the Desert,36000000,0,1578543,-34421457,4,1578543,2017,-95.61515833333334
1622,23,2003-03-28,Head of State,35200000,37788228,38283765,3083765,3,495537,2003,8.760696022727272
1623,24,2017-09-08,It,35000000,327481748,697457969,662457969,9,369976221,2017,1892.7370542857143
1624,25,2009-06-05,The Hangover,35000000,277322503,465764086,430764086,6,188441583,2009,1230.7545314285715
1625,26,2009-11-20,The Blind Side,35000000,255959475,305705794,270705794,11,49746319,2009,773.4451257142857
1626,27,1989-06-23,Batman,35000000,251188924,411348924,376348924,6,160160000,1989,1075.28264
1627,28,1999-06-10,Austin Powers: The Spy Who Shagged Me,35000000,206040085,312383487,277383487,6,106343402,1999,792.5242485714285
1628,29,2010-12-22,True Grit,35000000,171243005,252276928,217276928,12,81033923,2010,620.7912228571429
1629,30,1992-05-15,Lethal Weapon 3,35000000,144731527,319700000,284700000,5,174968473,1992,813.4285714285713
1630,31,1998-09-18,Rush Hour,35000000,141186864,245300000,210300000,9,104113136,1998,600.8571428571429
1631,32,2013-02-08,Identity Thief,35000000,134506920,175361578,140361578,2,40854658,2013,401.03308000000004
1632,33,2006-06-30,The Devil Wears Prada,35000000,124740460,326073155,291073155,6,201332695,2006,831.6375857142857
1633,34,2011-07-08,Horrible Bosses,35000000,117538559,212417601,177417601,7,94879042,2011,506.90743142857144
1634,35,2001-03-30,Spy Kids,35000000,112692062,197692062,162692062,3,85000000,2001,464.83446285714285
1635,36,2015-07-17,Trainwreck,35000000,110212700,141123897,106123897,7,30911197,2015,303.21113428571425
1636,37,2013-12-13,Saving Mr. Banks,35000000,83299761,114962525,79962525,12,31662764,2013,228.46435714285715
1637,38,1979-12-07,Star Trek: The Motion Picture,35000000,82258456,139000000,104000000,12,56741544,1979,297.14285714285717
1638,39,2008-03-28,21,35000000,81159365,159846429,124846429,3,78687064,2008,356.7040828571429
1639,40,2008-05-09,What Happens in Vegas...,35000000,80277646,218535708,183535708,5,138258062,2008,524.3877371428572
1640,41,1991-11-15,Cape Fear,35000000,79091969,182291969,147291969,11,103200000,1991,420.83419714285714
1641,42,1996-11-15,The English Patient,35000000,78716374,231710008,196710008,11,152993634,1996,562.0285942857142
1642,43,2009-01-16,Hotel for Dogs,35000000,73178547,122357172,87357172,1,49178625,2009,249.59192
1643,44,2005-03-25,Guess Who,35000000,68915888,102115888,67115888,3,33200000,2005,191.75968
1644,45,2012-12-21,This is 40,35000000,67544505,90221182,55221182,12,22676677,2012,157.7748057142857
1645,46,1997-09-19,L.A. Confidential,35000000,64604977,126204977,91204977,9,61600000,1997,260.5856485714286
1646,47,2005-07-29,Sky High,35000000,63939454,83109359,48109359,7,19169905,2005,137.45531142857143
1647,48,1997-09-19,In & Out,35000000,63826569,83226569,48226569,9,19400000,1997,137.79019714285715
1648,49,2010-04-30,A Nightmare on Elm Street,35000000,63075011,117729621,82729621,4,54654610,2010,236.3703457142857
1649,50,2000-08-18,The Cell,35000000,61280963,85911226,50911226,8,24630263,2000,145.46064571428573
1650,51,1995-07-07,Species,35000000,60054449,113354449,78354449,7,53300000,1995,223.86985428571427
1651,52,2006-04-07,The Benchwarmers,35000000,59843754,65063726,30063726,4,5219972,2006,85.89636
1652,53,2010-10-08,Secretariat,35000000,59699513,60376247,25376247,10,676734,2010,72.50356285714285
1653,54,1998-03-13,The Man in the Iron Mask,35000000,56968169,56968169,21968169,3,0,1998,62.76619714285714
1654,55,2011-07-22,Friends with Benefits,35000000,55802754,146595891,111595891,7,90793137,2011,318.84540285714286
1655,56,2016-05-20,Neighbors 2: Sorority Rising,35000000,55340730,108757621,73757621,5,53416891,2016,210.73605999999998
1656,57,2007-03-23,TMNT,35000000,54149098,96096018,61096018,3,41946920,2007,174.56005142857143
1657,58,2003-10-24,Radio,35000000,52333738,53293628,18293628,10,959890,2003,52.267508571428564
1658,59,2018-06-29,Sicario: Day of the Soldado,35000000,50065850,75885196,40885196,6,25819346,2018,116.81484571428571
1659,60,2009-11-25,Old Dogs,35000000,49492060,95104304,60104304,11,45612244,2009,171.72658285714286
1660,61,1992-11-18,Malcolm X,35000000,48169910,48169910,13169910,11,0,1992,37.62831428571429
1661,62,2015-05-22,Poltergeist,35000000,47425125,95713069,60713069,5,48287944,2015,173.46591142857142
1662,63,2018-10-12,Goosebumps 2: Haunted Halloween,35000000,46697321,93291478,58291478,10,46594157,2018,166.54708
1663,64,2018-01-19,12 Strong,35000000,45819713,71118378,36118378,1,25298665,2018,103.19536571428571
1664,65,2009-01-23,Underworld 3: Rise of the Lycans,35000000,45802315,89102315,54102315,1,43300000,2009,154.57804285714286
1665,66,2005-07-29,Must Love Dogs,35000000,43894863,58405313,23405313,7,14510450,2005,66.87232285714285
1666,67,2007-07-03,License to Wed,35000000,43799818,70187088,35187088,7,26387270,2007,100.53453714285713
1667,68,1997-02-28,Donnie Brasco,35000000,41954997,65303052,30303052,2,23348055,1997,86.58014857142857
1668,69,2008-10-17,Max Payne,35000000,40689393,87775050,52775050,10,47085657,2008,150.78585714285714
1669,70,2002-03-15,Resident Evil,35000000,40119709,103787401,68787401,3,63667692,2002,196.53543142857143
1670,71,2004-03-26,The Ladykillers,35000000,39692139,77392139,42392139,3,37700000,2004,121.12039714285714
1671,72,2011-05-06,Something Borrowed,35000000,39046489,65084116,30084116,5,26037627,2011,85.95461714285715
1672,73,2006-12-01,The Nativity Story,35000000,37629831,46309644,11309644,12,8679813,2006,32.31326857142857
1673,74,2011-10-28,In Time,35000000,37553932,165103952,130103952,10,127550020,2011,371.72557714285716
1674,75,2010-04-23,The Back-up Plan,35000000,37490007,75281179,40281179,4,37791172,2010,115.08908285714286
1675,76,2011-11-09,J. Edgar,35000000,37306030,84606030,49606030,11,47300000,2011,141.7315142857143
1676,77,2000-11-17,Bounce,35000000,36805288,53425292,18425292,11,16620004,2000,52.64369142857143
1677,78,2018-08-17,Mile 22,35000000,36108758,66295121,31295121,8,30186363,2018,89.41463142857144
1678,79,2015-05-08,Hot Pursuit,35000000,34580201,45671512,10671512,5,11091311,2015,30.490034285714284
1679,80,2015-12-25,Concussion,35000000,34531832,50363790,15363790,12,15831958,2015,43.896542857142855
1680,81,2017-10-13,The Foreigner,35000000,34393507,140783360,105783360,10,106389853,2017,302.23817142857143
1681,82,2004-12-03,Closer,35000000,33987757,116177695,81177695,12,82189938,2004,231.93627142857144
1682,83,1994-12-23,Street Fighter,35000000,33423000,99423000,64423000,12,66000000,1994,184.06571428571428
1683,84,2001-11-21,Black Knight,35000000,33422806,33422806,-1577194,11,0,2001,-4.5062685714285715
1684,85,2005-07-22,The Bad News Bears,35000000,32868349,33500620,-1499380,7,632271,2005,-4.283942857142857
1685,86,2002-12-27,The Pianist,35000000,32519322,111854182,76854182,12,79334860,2002,219.58337714285716
1686,87,2005-05-06,House of Wax,35000000,32064800,70064800,35064800,5,38000000,2005,100.18514285714286
1687,88,2001-10-19,From Hell,35000000,31598308,68712365,33712365,10,37114057,2001,96.32104285714286
1688,89,2018-06-01,Adrift,35000000,31445011,57897191,22897191,6,26452180,2018,65.42054571428572
1689,90,2008-08-15,Mirrors,35000000,30691439,77220596,42220596,8,46529157,2008,120.6302742857143
1690,91,2017-01-06,Underworld: Blood Wars,35000000,30353973,81209222,46209222,1,50855249,2017,132.02634857142857
1691,92,2002-02-22,Queen of the Damned,35000000,30307804,30307804,-4692196,2,0,2002,-13.406274285714288
1692,93,2010-08-20,Nanny McPhee and the Big Bang,35000000,29197642,97799865,62799865,8,68602223,2010,179.42818571428572
1693,94,2008-01-25,Untraceable,35000000,28687835,52649951,17649951,1,23962116,2008,50.42843142857143
1694,95,1990-11-21,Predator 2,35000000,28317513,54768418,19768418,11,26450905,1990,56.48119428571429
1695,96,2011-09-23,Abduction,35000000,28087155,86648359,51648359,9,58561204,2011,147.56674
1696,97,1980-12-05,Flash Gordon,35000000,27107960,27107960,-7892040,12,0,1980,-22.548685714285714
1697,98,2008-03-28,Superhero Movie,35000000,26638520,73026302,38026302,3,46387782,2008,108.64657714285715
1698,99,1999-02-12,Blast from the Past,35000000,26613620,26613620,-8386380,2,0,1999,-23.961085714285716
1699,100,2012-10-19,Alex Cross,35000000,25888412,35426759,426759,10,9538347,2012,1.2193114285714286
1700,1,2004-03-26,Jersey Girl,35000000,25266129,37066129,2066129,3,11800000,2004,5.903225714285714
1701,2,1997-11-21,Midnight in the Garden of Good and Evil,35000000,25078937,25078937,-9921063,11,0,1997,-28.345894285714284
1702,3,2016-09-16,Bridget Jonesâs Baby,35000000,24139805,205822688,170822688,9,181682883,2016,488.0648228571428
1703,4,2001-11-09,Heist,35000000,23483357,28906817,-6093183,11,5423460,2001,-17.409094285714286
1704,5,1992-12-25,Hoffa,35000000,23365858,28391473,-6608527,12,5025615,1992,-18.881505714285716
1705,6,2016-03-04,Whiskey Tango Foxtrot,35000000,23083334,25350747,-9649253,3,2267413,2016,-27.569294285714285
1706,7,2004-04-09,Ella Enchanted,35000000,22913677,22913677,-12086323,4,0,2004,-34.53235142857143
1707,8,2015-08-21,Hitman: Agent 47,35000000,22467450,82182803,47182803,8,59715353,2015,134.80800857142856
1708,9,2008-07-25,The X-Files: I Want to Believe,35000000,20982478,68170792,33170792,7,47188314,2008,94.77369142857142
1709,10,2012-08-24,Premium Rush,35000000,20275446,31393201,-3606799,8,11117755,2012,-10.30514
1710,11,2013-01-18,Broken City,35000000,19701164,34480045,-519955,1,14778881,2013,-1.4855857142857143
1711,12,2005-08-19,Valiant,35000000,19478106,64188387,29188387,8,44710281,2005,83.39539142857143
1712,13,2000-02-23,Wonder Boys,35000000,19389454,33422485,-1577515,2,14033031,2000,-4.507185714285714
1713,14,2005-02-25,Cursed,35000000,19294901,25114901,-9885099,2,5820000,2005,-28.24314
1714,15,2007-12-21,Walk Hard: The Dewey Cox Story,35000000,18317151,20606053,-14393947,12,2288902,2007,-41.12556285714285
1715,16,2002-09-20,The Four Feathers,35000000,18306166,29882645,-5117355,9,11576479,2002,-14.621014285714285
1716,17,2010-04-30,Furry Vengeance,35000000,17630465,39340177,4340177,4,21709712,2010,12.400505714285714
1717,18,2013-01-25,Parker,35000000,17616641,48543388,13543388,1,30926747,2013,38.695394285714286
1718,19,2004-09-17,Wimbledon,35000000,16862585,41666476,6666476,9,24803891,2004,19.047074285714285
1719,20,2000-09-15,Bait,35000000,15325127,15471969,-19528031,9,146842,2000,-55.79437428571429
1720,21,2000-12-08,Dungeons and Dragons,35000000,15185241,33771965,-1228035,12,18586724,2000,-3.508671428571428
1721,22,2007-11-09,Lions for Lambs,35000000,14998070,63211088,28211088,11,48213018,2007,80.60310857142858
1722,23,1991-01-18,Flight of the Intruder,35000000,14471440,14471440,-20528560,1,0,1991,-58.653028571428564
1723,24,2011-05-27,The Tree of Life,35000000,13305665,61721826,26721826,5,48416161,2011,76.34807428571429
1724,25,2001-08-17,American Outlaws,35000000,13264986,13601109,-21398891,8,336123,2001,-61.13968857142857
1725,26,2006-08-11,Zoom,35000000,11989328,12506188,-22493812,8,516860,2006,-64.26803428571428
1726,27,2001-12-25,The Shipping News,35000000,11405825,24405825,-10594175,12,13000000,2001,-30.269071428571433
1727,28,2009-12-18,The Young Victoria,35000000,11001272,31878891,-3121109,12,20877619,2009,-8.917454285714285
1728,29,2014-03-28,Sabotage,35000000,10508518,18376443,-16623557,3,7867925,2014,-47.49587714285714
1729,30,1998-09-04,Knock Off,35000000,10319915,10319915,-24680085,9,0,1998,-70.51452857142857
1730,31,2009-09-11,Whiteout,35000000,10275638,12254746,-22745254,9,1979108,2009,-64.98644
1731,32,2015-03-06,Unfinished Business,35000000,10219501,13214051,-21785949,3,2994550,2015,-62.245568571428564
1732,33,2015-09-30,The Walk,35000000,10161183,61492104,26492104,9,51330921,2015,75.69172571428572
1733,34,2006-11-22,The Fountain,35000000,10144010,15461638,-19538362,11,5317628,2006,-55.82389142857143
1734,35,2013-11-29,Mandela: Long Walk to Freedom,35000000,8323085,29890402,-5109598,11,21567317,2013,-14.59885142857143
1735,36,2008-12-05,Punisher: War Zone,35000000,8050977,10157534,-24842466,12,2106557,2008,-70.97847428571428
1736,37,2003-09-05,The Order,35000000,7659747,11559747,-23440253,9,3900000,2003,-66.97215142857142
1737,38,2006-11-10,A Good Year,35000000,7459300,42064105,7064105,11,34604805,2006,20.18315714285714
1738,39,2016-03-11,The Brothers Grimsby,35000000,6864016,28720470,-6279530,3,21856454,2016,-17.941514285714284
1739,40,2017-10-20,The Snowman,35000000,6670765,43226146,8226146,10,36555381,2017,23.503274285714284
1740,41,2002-11-06,Femme Fatale,35000000,6630252,16830252,-18169748,11,10200000,2002,-51.91356571428572
1741,42,1997-05-02,Warriors of Virtue,35000000,6448817,6448817,-28551183,5,0,1997,-81.57480857142858
1742,43,2003-09-26,Luther,35000000,5781086,32717063,-2282937,9,26935977,2003,-6.522677142857143
1743,44,2011-01-28,Biutiful,35000000,5101237,24687524,-10312476,1,19586287,2011,-29.46421714285714
1744,45,1992-02-21,Radio Flyer,35000000,4651977,4651977,-30348023,2,0,1992,-86.70863714285714
1745,46,1993-04-16,Bound by Honor,35000000,4496583,4496583,-30503417,4,0,1993,-87.15262
1746,47,2016-04-22,A Hologram for the King,35000000,4212494,11846010,-23153990,4,7633516,2016,-66.15425714285715
1747,48,1997-02-28,Smilla's Sense of Snow,35000000,2221994,2221994,-32778006,2,0,1997,-93.65144571428571
1748,49,1986-10-03,Playing for Keeps,35000000,2000000,2000000,-33000000,10,0,1986,-94.28571428571428
1749,50,1980-01-01,Lion of the Desert,35000000,1500000,1500000,-33500000,1,0,1980,-95.71428571428572
1750,51,1996-04-19,Le hussard sur le toit,35000000,1320043,1320043,-33679957,4,0,1996,-96.22844857142857
1751,52,1999-11-24,Ride With the Devil,35000000,630779,630779,-34369221,11,0,1999,-98.19777428571429
1752,53,2012-09-14,Stolen,35000000,289773,17967746,-17032254,9,17677973,2012,-48.663582857142856
1753,54,2011-10-14,Trespass,35000000,16816,786532,-34213468,10,769716,2011,-97.75276571428572
1754,55,2006-09-22,Bandidas,35000000,0,19282590,-15717410,9,19282590,2006,-44.906885714285714
1755,56,2015-03-13,The Lovers,35000000,0,53899,-34946101,3,53899,2015,-99.84600285714286
1756,57,2008-12-31,Black Water Transit,35000000,0,0,-35000000,12,0,2008,-100.0
1757,58,2011-12-25,The Darkest Hour,34800000,21443494,62831715,28031715,12,41388221,2011,80.55090517241379
1758,59,2017-06-28,Baby Driver,34000000,107825862,228104185,194104185,6,120278323,2017,570.8946617647059
1759,60,2014-09-19,The Maze Runner,34000000,102427862,348319861,314319861,9,245891999,2014,924.4701794117648
1760,61,2015-04-10,The Longest Ride,34000000,37446117,63802928,29802928,4,26356811,2015,87.6556705882353
1761,62,1993-09-17,The Age of Innocence,34000000,32014993,32014993,-1985007,9,0,1993,-5.838255882352941
1762,63,2009-08-14,Gake no ue no Ponyo,34000000,15090399,205312666,171312666,8,190222267,2009,503.86078235294116
1763,64,2018-08-03,The Darkest Minds,34000000,12695691,38361428,4361428,8,25665737,2018,12.827729411764707
1764,65,1999-09-01,Chill Factor,34000000,11263966,11263966,-22736034,9,0,1999,-66.87068823529412
1765,66,1999-08-27,The Astronaut's Wife,34000000,10672566,10672566,-23327434,8,0,1999,-68.6101
1766,67,2000-05-05,I Dreamed of Africa,34000000,6543194,14291999,-19708001,5,7748805,2000,-57.964708823529406
1767,68,2014-09-05,Thunder and the House of Magic,34000000,4091,62582520,28582520,9,62578429,2014,84.06623529411765
1768,69,1981-12-04,Reds,33500000,50000000,50000000,16500000,12,0,1981,49.25373134328358
1769,70,1992-12-11,A Few Good Men,33000000,141340178,236500000,203500000,12,95159822,1992,616.6666666666667
1770,71,2000-06-02,Big Momma's House,33000000,117559438,173559438,140559438,6,56000000,2000,425.93769090909086
1771,72,2001-03-16,Exit Wounds,33000000,51758599,79958599,46958599,3,28200000,2001,142.29878484848484
1772,73,2016-07-08,Mike and Dave Need Wedding Dates,33000000,46009673,75898100,42898100,7,29888427,2016,129.99424242424243
1773,74,2012-07-27,Step Up Revolution,33000000,35074677,165552290,132552290,7,130477613,2012,401.67360606060606
1774,75,2006-08-18,Snakes on a Plane,33000000,34020814,62020814,29020814,8,28000000,2006,87.9418606060606
1775,76,2004-04-16,The Punisher,33000000,33664370,54533774,21533774,4,20869404,2004,65.25386060606061
1776,77,2000-09-08,The Watcher,33000000,28946615,47267829,14267829,9,18321214,2000,43.235845454545455
1777,78,2012-04-27,Safe,33000000,17142080,41495213,8495213,4,24353133,2012,25.743069696969695
1778,79,2008-03-14,Doomsday,33000000,11008770,21621188,-11378812,3,10612418,2008,-34.481248484848486
1779,80,1999-04-23,Pushing Tin,33000000,8408835,8408835,-24591165,4,0,1999,-74.51868181818182
1780,81,2006-05-12,Goal! The Dream Begins,33000000,4283255,27610873,-5389127,5,23327618,2006,-16.330687878787877
1781,82,2015-07-31,The Young and Prodigious T.S. Spivet,33000000,176847,357687,-32642313,7,180840,2015,-98.9161
1782,83,2015-10-30,Freaks of Nature,33000000,70958,70958,-32929042,10,0,2015,-99.78497575757575
1783,84,1983-05-25,Star Wars Ep. VI: Return of the Jedi,32500000,309205079,572705079,540205079,5,263500000,1983,1662.1694738461538
1784,85,2011-05-13,Bridesmaids,32500000,169211718,289632023,257132023,5,120420305,2011,791.1754553846154
1785,86,2008-12-10,The Reader,32500000,34194407,112964875,80464875,12,78770468,2008,247.58423076923077
1786,87,2013-04-26,The Big Wedding,32500000,21819348,48425971,15925971,4,26606623,2013,49.00298769230769
1787,88,2012-02-24,Wanderlust,32500000,17288155,24159934,-8340066,2,6871779,2012,-25.66174153846154
1788,89,2003-11-07,Elf,32000000,173840591,220678483,188678483,11,46837892,2003,589.620259375
1789,90,1996-07-05,Phenomenon,32000000,104636382,152036382,120036382,7,47400000,1996,375.11369375000004
1790,91,2013-06-12,This is the End,32000000,101470202,126539117,94539117,6,25068915,2013,295.434740625
1791,92,2002-01-18,Snow Dogs,32000000,81150692,116898028,84898028,1,35747336,2002,265.3063375
1792,93,2006-06-16,Nacho Libre,32000000,80197993,99296462,67296462,6,19098469,2006,210.30144375
1793,94,1988-11-23,Scrooged,32000000,59450353,59450353,27450353,11,0,1988,85.782353125
1794,95,2010-08-27,Takers,32000000,57744720,70587268,38587268,8,12842548,2010,120.58521250000001
1795,96,2011-04-01,Source Code,32000000,54712227,140428499,108428499,4,85716272,2011,338.83905937500003
1796,97,1999-09-10,Stigmata,32000000,50041732,89441732,57441732,9,39400000,1999,179.5054125
1797,98,2000-11-10,Men of Honor,32000000,48814909,82339483,50339483,11,33524574,2000,157.310884375
1798,99,2018-04-20,I Feel Pretty,32000000,48795601,91553797,59553797,4,42758196,2018,186.105615625
1799,100,2005-09-02,The Transporter 2,32000000,43095856,88978458,56978458,9,45882602,2005,178.05768125
1800,1,2011-02-18,"Big Mommas: Like Father, Like Son",32000000,37915414,82332450,50332450,2,44417036,2011,157.28890625
1801,2,1993-01-15,Alive,32000000,36299670,36299670,4299670,1,0,1993,13.43646875
1802,3,2007-02-23,The Number 23,32000000,35193167,77593167,45593167,2,42400000,2007,142.478646875
1803,4,1979-12-14,1941,32000000,34175000,94875000,62875000,12,60700000,1979,196.484375
1804,5,2005-10-21,Dreamer: Inspired by a True Story,32000000,33022286,39498360,7498360,10,6476074,2005,23.432375
1805,6,2005-09-23,A History of Violence,32000000,31493782,61477797,29477797,9,29984015,2005,92.118115625
1806,7,2013-03-15,The Incredible Burt Wonderstone,32000000,22537881,27392609,-4607391,3,4854728,2013,-14.398096875
1807,8,1995-02-10,The Quick and the Dead,32000000,18552460,18552460,-13447540,2,0,1995,-42.0235625
1808,9,2004-04-30,Laws of Attraction,32000000,17848322,29948322,-2051678,4,12100000,2004,-6.41149375
1809,10,2018-10-12,Bad Times at the El Royale,32000000,17839115,29204379,-2795621,10,11365264,2018,-8.736315625
1810,11,2010-09-03,Going the Distance,32000000,17804299,43603990,11603990,9,25799691,2010,36.26246875
1811,12,1999-10-22,Bringing Out The Dead,32000000,16640210,16640210,-15359790,10,0,1999,-47.99934375
1812,13,2010-03-19,Repo Men,32000000,13942007,18195238,-13804762,3,4253231,2010,-43.13988125
1813,14,2007-09-14,Dragon Wars: D-War,32000000,10977721,79915361,47915361,9,68937640,2007,149.73550312499998
1814,15,1996-09-06,Bogus,32000000,4357406,4357406,-27642594,9,0,1996,-86.38310625
1815,16,1997-03-26,Cats Don't Dance,32000000,3588602,3588602,-28411398,3,0,1997,-88.78561875
1816,17,1999-12-08,Cradle Will Rock,32000000,2899970,2899970,-29100030,12,0,1999,-90.93759375
1817,18,2006-12-15,The Good German,32000000,1308696,6678033,-25321967,12,5369337,2006,-79.131146875
1818,19,2004-12-31,George and the Dragon,32000000,0,0,-32000000,12,0,2004,-100.0
1819,20,1979-08-15,Apocalypse Now,31500000,78800000,81250485,49750485,8,2450485,1979,157.9380476190476
1820,21,2016-04-15,Criminal,31500000,14708696,38771262,7271262,4,24062566,2016,23.08337142857143
1821,22,2013-04-12,42,31000000,95020213,97470701,66470701,4,2450488,2013,214.42161612903226
1822,23,2012-11-02,Flight,31000000,93772375,160558438,129558438,11,66786063,2012,417.9304451612904
1823,24,1995-12-29,Mr. Hollandâs Opus,31000000,82582604,106282604,75282604,12,23700000,1995,242.84710967741935
1824,25,1985-12-18,Out of Africa,31000000,79096868,258210860,227210860,12,179113992,1985,732.9382580645162
1825,26,1979-06-29,Moonraker,31000000,70300000,210300000,179300000,6,140000000,1979,578.3870967741935
1826,27,2014-03-07,The Grand Budapest Hotel,31000000,59076019,163981261,132981261,3,104905242,2014,428.97180967741934
1827,28,2015-07-29,Vacation,31000000,58884188,102306500,71306500,7,43422312,2015,230.0209677419355
1828,29,1990-07-18,Arachnophobia,31000000,53208180,53208180,22208180,7,0,1990,71.63929032258064
1829,30,2019-02-13,Isnât it Romantic,31000000,48791187,48791187,17791187,2,0,2019,57.39092580645161
1830,31,2000-04-28,Frequency,31000000,44983704,68079671,37079671,4,23095967,2000,119.61184193548387
1831,32,2001-09-28,Hearts in Atlantis,31000000,24185781,30885781,-114219,9,6700000,2001,-0.3684483870967742
1832,33,2010-01-22,Extraordinary Measures,31000000,12482741,15826984,-15173016,1,3344243,2010,-48.9452129032258
1833,34,2017-08-25,Birth of the Dragon,31000000,6901965,7220490,-23779510,8,318525,2017,-76.70809677419355
1834,35,1995-10-20,Get Shorty,30250000,72021008,115021008,84771008,10,43000000,1995,280.2347371900826
1835,36,1984-06-08,Ghostbusters,30000000,242212467,295212467,265212467,6,53000000,1984,884.0415566666668
1836,37,1995-11-22,Toy Story,30000000,191796233,364545516,334545516,11,172749283,1995,1115.15172
1837,38,2018-08-15,Crazy Rich Asians,30000000,174532921,238099711,208099711,8,63566790,2018,693.6657033333333
1838,39,2002-12-27,Chicago,30000000,170687518,306770545,276770545,12,136083027,2002,922.5684833333335
1839,40,1999-06-25,Big Daddy,30000000,163479795,228641283,198641283,6,65161488,1999,662.13761
1840,41,2001-08-10,American Pie 2,30000000,145096820,286500000,256500000,8,141403180,2001,855.0000000000001
1841,42,2012-02-10,The Vow,30000000,125014030,197618160,167618160,2,72604130,2012,558.7271999999999
1842,43,1994-06-10,Speed,30000000,121248145,283200000,253200000,6,161951855,1994,844.0
1843,44,1990-03-02,The Hunt for Red October,30000000,120709866,200500000,170500000,3,79790134,1990,568.3333333333334
1844,45,2013-08-16,Lee Daniels' The Butler,30000000,116632095,177025498,147025498,8,60393403,2013,490.08499333333333
1845,46,2000-09-29,Remember the Titans,30000000,115654751,136706683,106706683,9,21051932,2000,355.6889433333333
1846,47,2009-08-14,District 9,30000000,115646235,212453431,182453431,8,96807196,2009,608.1781033333334
1847,48,2004-06-18,Dodgeball: A True Underdog Story,30000000,114326736,167791704,137791704,6,53464968,2004,459.30568000000005
1848,49,1991-11-22,The Addams Family,30000000,113502246,191502246,161502246,11,78000000,1991,538.34082
1849,50,1995-11-10,Ace Ventura: When Nature Calls,30000000,108360063,212400000,182400000,11,104039937,1995,608.0
1850,51,2001-08-03,The Princess Diaries,30000000,108244774,165334774,135334774,8,57090000,2001,451.1159133333333
1851,52,1999-03-05,Analyze This,30000000,106885658,176885658,146885658,3,70000000,1999,489.61886000000004
1852,53,1996-09-20,The First Wives Club,30000000,105489203,181489203,151489203,9,76000000,1996,504.96401000000003
1853,54,2004-12-15,Million Dollar Baby,30000000,100492203,231928227,201928227,12,131436024,2004,673.09409
1854,55,1995-09-22,Se7en,30000000,100125643,328125643,298125643,9,228000000,1995,993.7521433333334
1855,56,2003-10-08,Mystic River,30000000,90135191,156822020,126822020,10,66686829,2003,422.7400666666667
1856,57,2015-12-18,Sisters,30000000,87044645,106030660,76030660,12,18986015,2015,253.43553333333335
1857,58,1999-11-10,Pokemon: The First Movie,30000000,85744662,163644662,133644662,11,77900000,1999,445.4822066666667
1858,59,2004-11-19,SpongeBob SquarePants: The Movie,30000000,85416609,142051255,112051255,11,56634646,2004,373.50418333333334
1859,60,2009-12-04,Up in the Air,30000000,83823381,166842739,136842739,12,83019358,2009,456.1424633333333
1860,61,2004-06-25,The Notebook,30000000,81001787,116025023,86025023,6,35023236,2004,286.7500766666667
1861,62,2009-04-10,Hannah Montana the Movie,30000000,79576189,169173206,139173206,4,89597017,2009,463.91068666666666
1862,63,2008-01-18,27 Dresses,30000000,76808654,160247805,130247805,1,83439151,2008,434.15935
1863,64,2000-11-17,Rugrats in Paris,30000000,76501438,103284813,73284813,11,26783375,2000,244.28271
1864,65,2017-08-18,The Hitmanâs Bodyguard,30000000,75468583,172778667,142778667,8,97310084,2017,475.92888999999997
1865,66,1991-12-25,The Prince of Tides,30000000,74787599,74787599,44787599,12,0,1991,149.29199666666665
1866,67,2005-08-12,Four Brothers,30000000,74494381,92494381,62494381,8,18000000,2005,208.3146033333333
1867,68,1994-12-23,Legends of the Fall,30000000,66502573,160502573,130502573,12,94000000,1994,435.0085766666667
1868,69,2012-09-28,Looper,30000000,66486205,170466405,140466405,9,103980200,2012,468.22135
1869,70,2013-02-01,Warm Bodies,30000000,66380662,115121608,85121608,2,48740946,2013,283.73869333333334
1870,71,2002-12-13,About Schmidt,30000000,65005217,107054484,77054484,12,42049267,2002,256.84828
1871,72,2014-01-17,The Nut Job,30000000,64251538,122529966,92529966,1,58278428,2014,308.43322
1872,73,2001-02-16,Down to Earth,30000000,64172251,71172251,41172251,2,7000000,2001,137.24083666666667
1873,74,1995-08-04,Babe,30000000,63658910,246100000,216100000,8,182441090,1995,720.3333333333333
1874,75,2012-08-08,Hope Springs,30000000,63536011,133085295,103085295,8,69549284,2012,343.61765
1875,76,2008-04-18,Forgetting Sarah Marshall,30000000,63172463,105173042,75173042,4,42000579,2008,250.57680666666667
1876,77,2004-10-08,Friday Night Lights,30000000,61255921,61950770,31950770,10,694849,2004,106.50256666666667
1877,78,1989-11-17,Harlem Nights,30000000,60857262,95857262,65857262,11,35000000,1989,219.5242066666667
1878,79,2008-04-25,Baby Mama,30000000,60494212,64170447,34170447,4,3676235,2008,113.90149000000001
1879,80,1998-05-29,Hope Floats,30000000,60110313,81529000,51529000,5,21418687,1998,171.76333333333332
1880,81,2009-01-09,Bride Wars,30000000,58715510,115150424,85150424,1,56434914,2009,283.83474666666666
1881,82,2004-08-20,Without a Paddle,30000000,58156435,65121280,35121280,8,6964845,2004,117.07093333333334
1882,83,2011-05-20,Midnight in Paris,30000000,56816662,162502774,132502774,5,105686112,2011,441.67591333333337
1883,84,2017-11-22,Darkest Hour,30000000,56443120,150807172,120807172,11,94364052,2017,402.6905733333333
1884,85,2005-10-05,Wallace & Gromit: The Curse of the Were-Rabbit,30000000,56068547,197593152,167593152,10,141524605,2005,558.64384
1885,86,2007-12-21,P.S. I Love You,30000000,53695808,155769678,125769678,12,102073870,2007,419.23226
1886,87,2005-09-23,Corpse Bride,30000000,53359111,114770654,84770654,9,61411543,2005,282.5688466666667
1887,88,2018-05-11,Life of the Party,30000000,53059911,65759911,35759911,5,12700000,2018,119.19970333333335
1888,89,2010-05-14,Letters to Juliet,30000000,53032453,82148538,52148538,5,29116085,2010,173.82846
1889,90,2001-04-06,Blow,30000000,52990775,83282296,53282296,4,30291521,2001,177.60765333333333
1890,91,1999-02-12,Message in a Bottle,30000000,52880016,52880016,22880016,2,0,1999,76.26671999999999
1891,92,2015-07-24,Southpaw,30000000,52421953,94156456,64156456,7,41734503,2015,213.85485333333332
1892,93,1989-06-09,Star Trek V: The Final Frontier,30000000,52210049,70200000,40200000,6,17989951,1989,134.0
1893,94,2017-07-28,Atomic Blonde,30000000,51573925,98345423,68345423,7,46771498,2017,227.81807666666666
1894,95,2002-07-03,Like Mike,30000000,51432423,62432423,32432423,7,11000000,2002,108.10807666666666
1895,96,1994-03-18,Naked Gun 33 1/3: The Final Insult,30000000,51041856,51041856,21041856,3,0,1994,70.13952
1896,97,2007-12-07,Atonement,30000000,50980159,129779728,99779728,12,78799569,2007,332.5990933333333
1897,98,1985-05-24,A View to a Kill,30000000,50327960,152627960,122627960,5,102300000,1985,408.75986666666665
1898,99,2005-01-14,Racing Stripes,30000000,49772522,89955540,59955540,1,40183018,2005,199.8518
1899,100,2015-09-18,Sicario,30000000,46889293,84393749,54393749,9,37504456,2015,181.31249666666668
1900,1,1989-09-22,Black Rain,30000000,45892212,45892212,15892212,9,0,1989,52.97404
1901,2,1987-06-26,Full Metal Jacket,30000000,45015999,45015999,15015999,6,0,1987,50.053329999999995
1902,3,2018-01-19,Den of Thieves,30000000,44947622,80131391,50131391,1,35183769,2018,167.10463666666666
1903,4,2012-04-13,The Three Stooges,30000000,44338224,54052249,24052249,4,9714025,2012,80.17416333333334
1904,5,2000-07-21,Pokemon 2000,30000000,43746923,133946923,103946923,7,90200000,2000,346.4897433333333
1905,6,2014-10-24,John Wick,30000000,43037835,76235001,46235001,10,33197166,2014,154.11667
1906,7,2006-01-13,Glory Road,30000000,42647449,42799060,12799060,1,151611,2006,42.66353333333333
1907,8,2015-04-24,The Age of Adaline,30000000,42629776,68984536,38984536,4,26354760,2015,129.94845333333333
1908,9,2010-08-06,Step Up 3D,30000000,42400223,165889117,135889117,8,123488894,2010,452.96372333333335
1909,10,2009-05-29,Drag Me To Hell,30000000,42100625,91388487,61388487,5,49287862,2009,204.62829
1910,11,2012-04-13,The Cabin in the Woods,30000000,42073277,70689968,40689968,4,28616691,2012,135.63322666666667
1911,12,2003-09-19,Secondhand Lions,30000000,42070939,47902566,17902566,9,5831627,2003,59.675219999999996
1912,13,2006-11-10,Stranger Than Fiction,30000000,40435190,53572822,23572822,11,13137632,2006,78.57607333333333
1913,14,2011-04-08,Hanna,30000000,40259119,65343694,35343694,4,25084575,2011,117.81231333333334
1914,15,2002-08-16,Blue Crush,30000000,40118420,51618420,21618420,8,11500000,2002,72.06139999999999
1915,16,2007-10-19,30 Days of Night,30000000,39568996,80276156,50276156,10,40707160,2007,167.58718666666667
1916,17,1986-12-19,Little Shop of Horrors,30000000,38747385,38747385,8747385,12,0,1986,29.15795
1917,18,2006-09-15,Gridiron Gang,30000000,38432823,41457834,11457834,9,3025011,2006,38.19278
1918,19,1988-07-20,Midnight Run,30000000,38413606,81613606,51613606,7,43200000,1988,172.04535333333334
1919,20,2008-01-25,Meet the Spartans,30000000,38233676,84646831,54646831,1,46413155,2008,182.15610333333333
1920,21,1987-11-13,The Running Man,30000000,38122000,38122000,8122000,11,0,1987,27.073333333333334
1921,22,2013-09-13,The Family,30000000,36918811,51078541,21078541,9,14159730,2013,70.26180333333333
1922,23,2018-02-09,The 15:17 to Paris,30000000,36276286,56096200,26096200,2,19819914,2018,86.98733333333334
1923,24,1997-11-21,Mortal Kombat: Annihilation,30000000,35927406,51327406,21327406,11,15400000,1997,71.09135333333333
1924,25,2011-07-01,Larry Crowne,30000000,35608245,61449135,31449135,7,25840890,2011,104.83045
1925,26,2013-10-18,Carrie,30000000,35266619,82409520,52409520,10,47142901,2013,174.69840000000002
1926,27,2006-04-07,Take the Lead,30000000,34742066,65390493,35390493,4,30648427,2006,117.96831
1927,28,2018-03-02,Death Wish,30000000,34017028,48575965,18575965,3,14558937,2018,61.91988333333334
1928,29,2010-11-24,Love and Other Drugs,30000000,32367005,102716321,72716321,11,70349316,2010,242.38773666666668
1929,30,2015-06-03,Entourage,30000000,32363404,46438538,16438538,6,14075134,2015,54.79512666666667
1930,31,2001-06-01,What's the Worst That Could Happen?,30000000,32267774,38462071,8462071,6,6194297,2001,28.206903333333333
1931,32,2013-02-08,Side Effects,30000000,32172757,66742138,36742138,2,34569381,2013,122.47379333333332
1932,33,2009-09-09,9,30000000,31749894,48559999,18559999,9,16810105,2009,61.866663333333335
1933,34,2014-07-02,Deliver Us from Evil,30000000,30577122,87956618,57956618,7,57379496,2014,193.18872666666667
1934,35,2014-08-01,Get on Up,30000000,30569935,33339868,3339868,8,2769933,2014,11.132893333333334
1935,36,2017-12-25,Mollyâs Game,30000000,28780744,53296424,23296424,12,24515680,2017,77.65474666666667
1936,37,2012-04-27,The Five-Year Engagement,30000000,28700285,61623819,31623819,4,32923534,2012,105.41273
1937,38,2004-04-02,The Prince & Me,30000000,28165882,29356757,-643243,4,1190875,2004,-2.144143333333333
1938,39,2011-07-15,Winnie the Pooh,30000000,26692846,50145607,20145607,7,23452761,2011,67.15202333333333
1939,40,1998-05-15,Bulworth,30000000,26528684,29203383,-796617,5,2674699,1998,-2.6553899999999997
1940,41,2003-06-13,Dumb and Dumberer: When Harry Met Lloyd,30000000,26214846,26214846,-3785154,6,0,2003,-12.61718
1941,42,2018-09-14,White Boy Rick,30000000,24004833,25947983,-4052017,9,1943150,2018,-13.506723333333333
1942,43,1995-08-04,Virtuosity,30000000,23998226,23998226,-6001774,8,0,1995,-20.005913333333332
1943,44,1998-09-18,One True Thing,30000000,23337196,26708196,-3291804,9,3371000,1998,-10.97268
1944,45,2011-02-04,Sanctum,30000000,23209310,108957098,78957098,2,85747788,2011,263.1903266666667
1945,46,2006-07-21,My Super Ex-Girlfriend,30000000,22530295,60772856,30772856,7,38242561,2006,102.57618666666666
1946,47,2017-08-25,Ballerina,30000000,21858070,96892829,66892829,8,75034759,2017,222.97609666666665
1947,48,2004-09-17,Mr. 3000,30000000,21800302,21827296,-8172704,9,26994,2004,-27.242346666666666
1948,49,2010-11-19,The Next Three Days,30000000,21148651,67255916,37255916,11,46107265,2010,124.18638666666666
1949,50,2018-01-12,Proud Mary,30000000,20868638,21709539,-8290461,1,840901,2018,-27.63487
1950,51,2004-08-06,Little Black Book,30000000,20422207,21758371,-8241629,8,1336164,2004,-27.47209666666667
1951,52,2005-01-19,Assault On Precinct 13,30000000,20040895,36040895,6040895,1,16000000,2005,20.13631666666667
1952,53,2013-10-04,Runner Runner,30000000,19316646,60512680,30512680,10,41196034,2013,101.70893333333333
1953,54,1998-02-06,The Replacement Killers,30000000,19035741,19035741,-10964259,2,0,1998,-36.54753
1954,55,2017-04-28,Baahubali 2: The Conclusion,30000000,18985794,263502914,233502914,4,244517120,2017,778.3430466666666
1955,56,2006-03-03,Ultraviolet,30000000,18522064,30962112,962112,3,12440048,2006,3.20704
1956,57,2005-10-21,North Country,30000000,18324242,23676771,-6323229,10,5352529,2005,-21.07743
1957,58,2011-08-19,Fright Night,30000000,18298649,40520649,10520649,8,22222000,2011,35.06883
1958,59,2017-09-15,mother!,30000000,17800004,42531076,12531076,9,24731072,2017,41.770253333333336
1959,60,2015-10-09,Steve Jobs,30000000,17766658,35579007,5579007,10,17812349,2015,18.59669
1960,61,2002-07-17,Eight Legged Freaks,30000000,17266505,36722311,6722311,7,19455806,2002,22.407703333333334
1961,62,1996-07-19,Fled,30000000,17192205,19892205,-10107795,7,2700000,1996,-33.69265
1962,63,2010-06-04,Splice,30000000,17010170,28542494,-1457506,6,11532324,2010,-4.8583533333333335
1963,64,2008-04-18,88 Minutes,30000000,16930884,32955399,2955399,4,16024515,2008,9.851329999999999
1964,65,2004-04-09,The Whole Ten Yards,30000000,16323969,26323969,-3676031,4,10000000,2004,-12.253436666666667
1965,66,1986-08-01,Howard the Duck,30000000,16295774,16295774,-13704226,8,0,1986,-45.680753333333335
1966,67,2008-10-24,Pride and Glory,30000000,15740721,43440721,13440721,10,27700000,2008,44.80240333333334
1967,68,2005-08-26,The Cave,30000000,15007991,27147991,-2852009,8,12140000,2005,-9.506696666666667
1968,69,2004-04-30,Godsend,30000000,14334645,16910708,-13089292,4,2576063,2004,-43.63097333333334
1969,70,2003-06-20,Alex & Emma,30000000,14208384,15358583,-14641417,6,1150199,2003,-48.804723333333335
1970,71,2004-09-03,Wicker Park,30000000,13001257,21577076,-8422924,9,8575819,2004,-28.076413333333335
1971,72,2005-12-25,The New World,30000000,12712093,26184400,-3815600,12,13472307,2005,-12.718666666666667
1972,73,2007-06-29,Evening,30000000,12406646,12885574,-17114426,6,478928,2007,-57.04808666666666
1973,74,2013-01-18,The Last Stand,30000000,12050299,48330757,18330757,1,36280458,2013,61.10252333333334
1974,75,1999-01-15,In Dreams,30000000,12017369,12017369,-17982631,1,0,1999,-59.94210333333333
1975,76,1999-03-12,Wing Commander,30000000,11578022,11578022,-18421978,3,0,1999,-61.40659333333333
1976,77,2001-01-12,Antitrust,30000000,10965209,17865209,-12134791,1,6900000,2001,-40.44930333333333
1977,78,2013-03-08,Dead Man Down,30000000,10895295,19599974,-10400026,3,8704679,2013,-34.66675333333333
1978,79,2011-04-29,Hoodwinked Too: Hood vs. Evil,30000000,10143779,23353111,-6646889,4,13209332,2011,-22.156296666666666
1979,80,2009-04-10,Dragonball Evolution,30000000,9362785,58228460,28228460,4,48865675,2009,94.09486666666666
1980,81,2004-09-24,First Daughter,30000000,9055010,10419084,-19580916,9,1364074,2004,-65.26971999999999
1981,82,2017-04-14,The Lost City of Z,30000000,8574339,17121823,-12878177,4,8547484,2017,-42.92725666666667
1982,83,2005-09-09,An Unfinished Life,30000000,8535575,18535575,-11464425,9,10000000,2005,-38.214749999999995
1983,84,2017-02-03,The Space Between Us,30000000,7885294,16481405,-13518595,2,8596111,2017,-45.06198333333333
1984,85,2009-12-25,The Imaginarium of Doctor Parnassus,30000000,7689607,64352607,34352607,12,56663000,2009,114.50868999999999
1985,86,2011-01-14,Barney's Version,30000000,7502560,8845575,-21154425,1,1343015,2011,-70.51475
1986,87,2002-09-20,Trapped,30000000,6916869,6916869,-23083131,9,0,2002,-76.94377
1987,88,2018-08-31,Kin,30000000,5718096,10096821,-19903179,8,4378725,2018,-66.34393
1988,89,1984-06-01,Once Upon a Time in America,30000000,5321508,5575648,-24424352,6,254140,1984,-81.41450666666667
1989,90,2017-09-22,Stronger,30000000,4211129,8786752,-21213248,9,4575623,2017,-70.71082666666668
1990,91,1999-01-22,Gloria,30000000,4167493,4967493,-25032507,1,800000,1999,-83.44169000000001
1991,92,2007-09-21,The Assassination of Jesse James by the Coward Robert Ford,30000000,3909149,15313631,-14686369,9,11404482,2007,-48.95456333333333
1992,93,2004-12-29,The Merchant of Venice,30000000,3765585,18765585,-11234415,12,15000000,2004,-37.44805
1993,94,2003-04-02,The Good Thief,30000000,3517797,6460758,-23539242,4,2942961,2003,-78.46414
1994,95,2005-08-17,Supercross,30000000,3102550,3252550,-26747450,8,150000,2005,-89.15816666666667
1995,96,2006-12-29,Miss Potter,30000000,3005605,35891257,5891257,12,32885652,2006,19.637523333333334
1996,97,2006-05-05,Wu ji,30000000,669625,35869934,5869934,5,35200309,2006,19.566446666666668
1997,98,2019-06-14,Shaft,30000000,600000,600000,-29400000,6,0,2019,-98.0
1998,99,2011-09-23,Machine Gun Preacher,30000000,538690,3721988,-26278012,9,3183298,2011,-87.59337333333333
1999,100,2018-02-02,Bilal: A New Breed of Hero,30000000,490973,648599,-29351401,2,157626,2018,-97.83800333333333
2000,1,2007-06-15,DOA: Dead or Alive,30000000,480314,7755686,-22244314,6,7275372,2007,-74.14771333333333
2001,2,2010-02-19,Le Petit Nicolas,30000000,201857,52339566,22339566,2,52137709,2010,74.46522
2002,3,2011-10-07,Xinhai geming,30000000,135739,8593154,-21406846,10,8457415,2011,-71.35615333333334
2003,4,2008-02-21,Genghis Khan: To the Ends of the Earth and Sea,30000000,3892,4874498,-25125502,2,4870606,2008,-83.75167333333333
2004,5,2015-01-30,Wild Card,30000000,3200,4315789,-25684211,1,4312589,2015,-85.61403666666666
2005,6,2015-06-05,United Passions,30000000,918,168832,-29831168,6,167914,2015,-99.43722666666666
2006,7,2010-12-31,Konferenz der Tiere,30000000,0,53048539,23048539,12,53048539,2010,76.82846333333333
2007,8,2015-12-01,Grace of Monaco,30000000,0,25199891,-4800109,12,25199891,2015,-16.000363333333333
2008,9,2016-03-08,Savva. Serdtse voyna,30000000,0,5015080,-24984920,3,5015080,2016,-83.28306666666667
2009,10,2007-12-14,Goodbye Bafana,30000000,0,2717302,-27282698,12,2717302,2007,-90.94232666666666
2010,11,2013-12-31,Space Pirate Captain Harlock,30000000,0,310985,-29689015,12,310985,2013,-98.96338333333333
2011,12,2003-12-31,Ripley's Game,30000000,0,0,-30000000,12,0,2003,-100.0
2012,13,2017-02-24,Collide,29200000,2280004,5466698,-23733302,2,3186694,2017,-81.27843150684932
2013,14,2015-05-15,Pitch Perfect 2,29000000,184296230,287625468,258625468,5,103329238,2015,891.8119586206897
2014,15,2005-11-18,Walk the Line,29000000,119519402,187707495,158707495,11,68188093,2005,547.2672241379311
2015,16,2018-09-28,Night School,29000000,77339130,103008792,74008792,9,25669662,2018,255.20273103448275
2016,17,2016-04-08,The Boss,29000000,63077560,78652207,49652207,4,15574647,2016,171.21450689655174
2017,18,1995-12-27,12 Monkeys,29000000,57141459,168841459,139841459,12,111700000,1995,482.2119275862069
2018,19,2003-09-12,Once Upon a Time in Mexico,29000000,56330657,97413527,68413527,9,41082870,2003,235.90871379310343
2019,20,2000-04-14,Keeping the Faith,29000000,37036404,45336404,16336404,4,8300000,2000,56.332427586206904
2020,21,2017-08-18,Logan Lucky,29000000,27778642,44264271,15264271,8,16485629,2017,52.635417241379315
2021,22,2016-08-12,Florence Foster Jenkins,29000000,27383770,56000339,27000339,8,28616569,2016,93.1046172413793
2022,23,1998-02-13,The Borrowers,29000000,22619589,54045832,25045832,2,31426243,1998,86.36493793103448
2023,24,2008-12-05,Frost/Nixon,29000000,18622031,28452945,-547055,12,9830914,2008,-1.886396551724138
2024,25,2004-11-12,Seed of Chucky,29000000,17016190,24716190,-4283810,11,7700000,2004,-14.771758620689655
2025,26,2002-08-23,Serving Sara,29000000,16930185,20146150,-8853850,8,3215965,2002,-30.53051724137931
2026,27,2002-12-31,Confessions of a Dangerous Mind,29000000,16007718,33013805,4013805,12,17006087,2002,13.840706896551724
2027,28,2009-08-26,Taking Woodstock,29000000,7460204,10066366,-18933634,8,2606162,2009,-65.28839310344827
2028,29,1987-11-06,Cry Freedom,29000000,5899797,25899797,-3100203,11,20000000,1987,-10.690355172413794
2029,30,2019-09-30,Unhinged,29000000,0,0,-29000000,9,0,2019,-100.0
2030,31,1999-09-24,Mumford,28700000,4559569,4559569,-24140431,9,0,1999,-84.113
2031,32,2005-03-04,The Jacket,28500000,6301131,15452978,-13047022,3,9151847,2005,-45.77902456140351
2032,33,1992-11-11,Aladdin,28000000,217350219,504050219,476050219,11,286700000,1992,1700.1793535714285
2033,34,1984-05-23,Indiana Jones and the Temple of Doom,28000000,179880271,333080271,305080271,5,153200000,1984,1089.5723964285714
2034,35,2015-08-14,Straight Outta Compton,28000000,161197785,202182981,174182981,8,40985196,2015,622.0820749999999
2035,36,2017-07-21,Girls Trip,28000000,115108515,140886353,112886353,7,25777838,2017,403.1655464285715
2036,37,1998-11-20,The Rugrats Movie,28000000,100494685,140894685,112894685,11,40400000,1998,403.19530357142855
2037,38,1988-07-15,Die Hard,28000000,81350242,139109346,111109346,7,57759104,1988,396.81909285714283
2038,39,2001-04-06,Along Came a Spider,28000000,74058698,105159085,77159085,4,31100387,2001,275.5681607142857
2039,40,2017-11-01,A Bad Moms Christmas,28000000,72110659,127710550,99710550,11,55599891,2017,356.1091071428571
2040,41,2013-02-14,Safe Haven,28000000,71399120,94050951,66050951,2,22651831,2013,235.8962535714286
2041,42,2015-12-11,The Big Short,28000000,70259870,133162752,105162752,12,62902882,2015,375.5812571428571
2042,43,2008-11-07,Role Models,28000000,67300955,94500826,66500826,11,27199871,2008,237.50295
2043,44,2014-10-10,"Alexander and the Terrible, Horrible, No Good, Very Bad Day",28000000,66954149,101379287,73379287,10,34425138,2014,262.06888214285715
2044,45,2004-02-06,Miracle,28000000,64378093,64474705,36474705,2,96612,2004,130.26680357142857
2045,46,2013-01-28,Last Vegas,28000000,63914167,112914167,84914167,1,49000000,2013,303.2648821428571
2046,47,2001-01-26,The Wedding Planner,28000000,60400856,94728529,66728529,1,34327673,2001,238.31617500000002
2047,48,2004-03-19,Dawn of the Dead,28000000,58990765,103452875,75452875,3,44462110,2004,269.47455357142854
2048,49,1981-06-26,For Your Eyes Only,28000000,54800000,195300000,167300000,6,140500000,1981,597.5
2049,50,2018-06-15,Tag,28000000,54730625,77026186,49026186,6,22295561,2018,175.09352142857142
2050,51,2001-12-14,The Royal Tenenbaums,28000000,52353636,71430876,43430876,12,19077240,2001,155.11027142857142
2051,52,2003-04-25,Identity,28000000,52131264,82183683,54183683,4,30052419,2003,193.51315357142857
2052,53,2001-10-05,Serendipity,28000000,50255310,77477297,49477297,10,27221987,2001,176.70463214285715
2053,54,2010-04-16,Kick-Ass,28000000,48071303,97531134,69531134,4,49459831,2010,248.32547857142856
2054,55,2001-09-28,Zoolander,28000000,45172250,60780981,32780981,9,15608731,2001,117.07493214285714
2055,56,1994-09-16,Timecop,28000000,44853581,102053581,74053581,9,57200000,1994,264.477075
2056,57,2007-07-27,No Reservations,28000000,43107979,91943956,63943956,7,48835977,2007,228.37127142857142
2057,58,1993-07-16,Hocus Pocus,28000000,39360491,39360491,11360491,7,0,1993,40.57318214285714
2058,59,2005-11-11,Pride & Prejudice,28000000,38372662,126549607,98549607,11,88176945,2005,351.96288214285715
2059,60,2011-08-12,30 Minutes or Less,28000000,37053924,40966716,12966716,8,3912792,2011,46.3097
2060,61,2000-12-22,Dracula 2000,28000000,33000377,33000377,5000377,12,0,2000,17.858489285714285
2061,62,1982-06-25,Blade Runner,28000000,32656328,39342912,11342912,6,6686584,1982,40.510400000000004
2062,63,1995-04-07,Rob Roy,28000000,31390587,31390587,3390587,4,0,1995,12.109239285714287
2063,64,2014-02-21,3 Days to Kill,28000000,30697999,38959900,10959900,2,8261901,2014,39.142500000000005
2064,65,2013-08-16,Kick-Ass 2,28000000,28795985,63129909,35129909,8,34333924,2013,125.46396071428572
2065,66,2007-10-12,We Own the Night,28000000,28563179,55307857,27307857,10,26744678,2007,97.52806071428571
2066,67,2014-09-19,A Walk Among the Tombstones,28000000,26017685,62108587,34108587,9,36090902,2014,121.81638214285715
2067,68,2010-01-15,The Spy Next Door,28000000,24307106,46752858,18752858,1,22445752,2010,66.97449285714285
2068,69,2014-04-25,Brick Mansions,28000000,20396829,73421224,45421224,4,53024395,2014,162.21865714285715
2069,70,2006-05-12,Just My Luck,28000000,17326650,38159905,10159905,5,20833255,2006,36.285374999999995
2070,71,2000-10-13,Lost Souls,28000000,16779636,31320293,3320293,10,14540657,2000,11.858189285714285
2071,72,2015-08-21,American Ultra,28000000,14439985,30295028,2295028,8,15855043,2015,8.196528571428571
2072,73,2003-04-18,Winged Migration,28000000,11689053,39134983,11134983,4,27445930,2003,39.76779642857143
2073,74,2016-02-05,Pride and Prejudice and Zombies,28000000,10907291,16638300,-11361700,2,5731009,2016,-40.5775
2074,75,1999-10-01,"Mystery, Alaska",28000000,8891623,8891623,-19108377,10,0,1999,-68.24420357142857
2075,76,2001-08-24,John Carpenterâs Ghosts of Mars,28000000,8434601,8434601,-19565399,8,0,2001,-69.876425
2076,77,1997-07-11,A Simple Wish,28000000,8165213,8165213,-19834787,7,0,1997,-70.83852499999999
2077,78,2015-10-30,Our Brand is Crisis,28000000,7002261,8594558,-19405442,10,1592297,2015,-69.30515
2078,79,1997-12-25,Kundun,28000000,5686694,5686694,-22313306,12,0,1997,-79.69037857142857
2079,80,2008-10-03,How to Lose Friends & Alienate People,28000000,2775593,12031443,-15968557,10,9255850,2008,-57.03056071428571
2080,81,2007-12-31,Alatriste,28000000,0,22860477,-5139523,12,22860477,2007,-18.355439285714287
2081,82,2007-06-01,Knocked Up,27500000,148761765,219265952,191765952,6,70504187,2007,697.3307345454546
2082,83,1983-06-10,Octopussy,27500000,67900000,187500000,160000000,6,119600000,1983,581.8181818181819
2083,84,2009-06-26,My Sister's Keeper,27500000,49200230,96673002,69173002,6,47472772,2009,251.5381890909091
2084,85,2008-02-08,Welcome Home Roscoe Jenkins,27500000,42436517,43607627,16107627,2,1171110,2008,58.573189090909096
2085,86,2012-01-13,Joyful Noise,27500000,30932113,31157914,3657914,1,225801,2012,13.301505454545454
2086,87,1984-12-14,A Passage to India,27500000,27187653,27187653,-312347,12,0,1984,-1.1358072727272728
2087,88,2006-12-25,Notes on a Scandal,27500000,17510118,50578411,23078411,12,33068293,2006,83.92149454545455
2088,89,2007-10-19,Rendition,27500000,9736045,26939925,-560075,10,17203880,2007,-2.036636363636364
2089,90,2011-10-28,Anonymous,27500000,4463292,15815509,-11684491,10,11352217,2011,-42.48905818181819
2090,91,2011-03-18,Limitless,27000000,79249455,155564919,128564919,3,76315464,2011,476.16636666666665
2091,92,1991-12-06,Star Trek VI: The Undiscovered Country,27000000,74888996,96900000,69900000,12,22011004,1991,258.8888888888889
2092,93,2002-06-07,The Divine Secrets of the Ya-Ya Sisterhood,27000000,69586544,73826768,46826768,6,4240224,2002,173.43247407407407
2093,94,1997-10-03,Kiss the Girls,27000000,60527873,60527873,33527873,10,0,1997,124.1773074074074
2094,95,1980-06-20,The Blues Brothers,27000000,57229890,57229890,30229890,6,0,1980,111.96255555555557
2095,96,1994-12-25,The Jungle Book,27000000,44342956,44342956,17342956,12,0,1994,64.23317037037037
2096,97,2008-08-06,The Sisterhood of the Traveling Pants 2,27000000,44089964,44270131,17270131,8,180167,2008,63.96344814814815
2097,98,2016-05-13,Money Monster,27000000,41012075,93466095,66466095,5,52454020,2016,246.1707222222222
2098,99,2002-05-17,About a Boy,27000000,40803000,130759651,103759651,5,89956651,2002,384.2950037037037
2099,100,2011-08-19,Spy Kids: All the Time in the World,27000000,38536376,80681183,53681183,8,42144807,2011,198.8191962962963
2100,1,1999-07-16,Lake Placid,27000000,31770413,31770413,4770413,7,0,1999,17.668196296296294
2101,2,2006-04-07,Lucky Number Slevin,27000000,22495466,55495466,28495466,4,33000000,2006,105.53876296296296
2102,3,1983-10-21,The Right Stuff,27000000,21500000,21500000,-5500000,10,0,1983,-20.37037037037037
2103,4,1984-07-20,Die Unendliche Geschichte,27000000,21300000,21392049,-5607951,7,92049,1984,-20.77018888888889
2104,5,1998-02-27,Dark City,27000000,14435076,27257061,257061,2,12821985,1998,0.9520777777777777
2105,6,2008-09-19,The Duchess,27000000,13848978,45160110,18160110,9,31311132,2008,67.25966666666666
2106,7,2010-10-01,Case 39,27000000,13261851,28773827,1773827,10,15511976,2010,6.56972962962963
2107,8,2005-06-10,The Honeymooners,27000000,12834849,13174426,-13825574,6,339577,2005,-51.205829629629626
2108,9,1985-06-21,Return to Oz,27000000,10618813,10618813,-16381187,6,0,1985,-60.671062962962964
2109,10,1998-03-27,The Newton Boys,27000000,10341093,10341093,-16658907,3,0,1998,-61.69965555555555
2110,11,2004-08-27,Suspect Zero,27000000,8712564,8712564,-18287436,8,0,2004,-67.73124444444446
2111,12,2007-11-02,Martian Child,27000000,7500310,9352089,-17647911,11,1851779,2007,-65.36263333333333
2112,13,2002-10-18,Formula 51,27000000,5204007,5204007,-21795993,10,0,2002,-80.7259
2113,14,1999-11-24,Flawless,27000000,4485485,4485485,-22514515,11,0,1999,-83.3870925925926
2114,15,2005-05-13,Mindhunters,27000000,4476235,16566235,-10433765,5,12090000,2005,-38.643574074074074
2115,16,2008-10-17,What Just Happened,27000000,1090947,2412123,-24587877,10,1321176,2008,-91.0662111111111
2116,17,2003-12-12,The Statement,27000000,765637,1545064,-25454936,12,779427,2003,-94.27754074074073
2117,18,2006-12-31,The Magic Flute,27000000,0,0,-27000000,12,0,2006,-100.0
2118,19,2016-11-23,Rules Donât Apply,26700000,3652206,3871448,-22828552,11,219242,2016,-85.50019475655431
2119,20,2009-01-16,Paul Blart: Mall Cop,26000000,146336178,185904750,159904750,1,39568572,2009,615.0182692307692
2120,21,2003-08-06,Freaky Friday,26000000,110222438,160822438,134822438,8,50600000,2003,518.5478384615385
2121,22,2005-08-19,The 40 Year-old Virgin,26000000,109449237,177344230,151344230,8,67894993,2005,582.0931923076923
2122,23,1998-12-11,Shakespeare in Love,26000000,100317794,279500000,253500000,12,179182206,1998,975.0
2123,24,1990-12-21,Kindergarten Cop,26000000,91457688,202000000,176000000,12,110542312,1990,676.9230769230769
2124,25,2008-08-06,Pineapple Express,26000000,87341380,102404019,76404019,8,15062639,2008,293.86161153846155
2125,26,1993-12-22,Philadelphia,26000000,77324422,201324422,175324422,12,124000000,1993,674.3247
2126,27,1998-07-31,Ever After: A Cinderella Story,26000000,65705772,65705772,39705772,7,0,1998,152.7145076923077
2127,28,1990-08-10,Flatliners,26000000,61308153,61308153,35308153,8,0,1990,135.80058846153847
2128,29,2003-08-15,Open Range,26000000,58331254,68613992,42613992,8,10282738,2003,163.89996923076924
2129,30,2005-08-19,Red Eye,26000000,57891803,96666486,70666486,8,38774683,2005,271.7941769230769
2130,31,2011-12-09,New Yearâs Eve,26000000,54544638,146850273,120850273,12,92305635,2011,464.80874230769234
2131,32,1977-06-15,A Bridge Too Far,26000000,50800000,50800000,24800000,6,0,1977,95.38461538461539
2132,33,2013-04-26,Pain & Gain,26000000,49875291,81275291,55275291,4,31400000,2013,212.5972730769231
2133,34,2003-01-31,Final Destination 2,26000000,46896664,90396664,64396664,1,43500000,2003,247.67947692307692
2134,35,2000-12-22,"O Brother, Where Art Thou?",26000000,45506619,75763814,49763814,12,30257195,2000,191.39928461538463
2135,36,2004-12-29,In Good Company,26000000,45489752,63489752,37489752,12,18000000,2004,144.19135384615385
2136,37,2010-01-22,Legion,26000000,40168080,67647574,41647574,1,27479494,2010,160.18297692307692
2137,38,2012-08-29,Lawless,26000000,37397291,54393687,28393687,8,16996396,2012,109.20648846153847
2138,39,2002-03-29,Clockstoppers,26000000,36985501,38788828,12788828,3,1803327,2002,49.187799999999996
2139,40,1985-07-10,Silverado,26000000,33200000,33200000,7200000,7,0,1985,27.692307692307693
2140,41,2009-12-04,Brothers,26000000,28544157,45043870,19043870,12,16499713,2009,73.24565384615384
2141,42,2014-10-17,The Best of Me,26000000,26766213,41059418,15059418,10,14293205,2014,57.92083846153846
2142,43,2004-03-12,Agent Cody Banks 2: Destination London,26000000,23514247,28703083,2703083,3,5188836,2004,10.396473076923076
2143,44,2001-08-03,Original Sin,26000000,16521410,16521410,-9478590,8,0,2001,-36.45611538461539
2144,45,2012-04-27,The Raven,26000000,16008272,30601801,4601801,4,14593529,2012,17.699234615384615
2145,46,2004-02-20,Welcome to Mooseport,26000000,14469428,14469428,-11530572,2,0,2004,-44.34835384615385
2146,47,1995-01-27,Highlander: The Final Dimension,26000000,13738574,13738574,-12261426,1,0,1995,-47.15933076923077
2147,48,2015-07-10,Self/Less,26000000,12279691,33667319,7667319,7,21387628,2015,29.48968846153846
2148,49,2001-08-24,The Curse of the Jade Scorpion,26000000,7496522,18496522,-7503478,8,11000000,2001,-28.85953076923077
2149,50,2013-10-18,The Fifth Estate,26000000,3254172,6154172,-19845828,10,2900000,2013,-76.33010769230769
2150,51,1997-02-21,Blood and Wine,26000000,1083350,1083350,-24916650,2,0,1997,-95.83326923076923
2151,52,2014-03-21,Blood Ties,26000000,42472,2923959,-23076041,3,2881487,2014,-88.75400384615385
2152,53,1997-08-24,The Grimm Brothers' Snow White,26000000,5000,5000,-25995000,8,0,1997,-99.98076923076923
2153,54,2015-06-30,Viy,26000000,0,34246770,8246770,6,34246770,2015,31.718346153846156
2154,55,2015-03-17,Accidental Love,26000000,0,135436,-25864564,3,135436,2015,-99.47909230769231
2155,56,2015-04-24,The Face of an Angel,26000000,0,0,-26000000,4,0,2015,-100.0
2156,57,1996-05-17,Flipper,25530000,20080020,30593313,5063313,5,10513293,1996,19.832796709753232
2157,58,2005-08-31,The Constant Gardener,25500000,33579798,86301599,60801599,8,52721801,2005,238.4376431372549
2158,59,2008-10-17,W.,25100000,25534493,28575778,3475778,10,3041285,2008,13.847721115537848
2159,60,2004-02-25,The Passion of the Christ,25000000,370782930,622341924,597341924,2,251558994,2004,2389.3676960000003
2160,61,1993-11-24,Mrs. Doubtfire,25000000,219195051,441286003,416286003,11,222090952,1993,1665.144012
2161,62,1988-12-16,Rain Man,25000000,172825435,412800000,387800000,12,239974565,1988,1551.2
2162,63,2011-08-10,The Help,25000000,169705587,213120004,188120004,8,43414417,2011,752.480016
2163,64,2016-12-25,Hidden Figures,25000000,169607287,231771716,206771716,12,62164429,2016,827.086864
2164,65,2008-12-12,Gran Torino,25000000,148095302,274543085,249543085,12,126447783,2008,998.17234
2165,66,2009-01-30,Taken,25000000,145000989,226941585,201941585,1,81940596,2009,807.76634
2166,67,2014-01-17,Ride Along,25000000,134202565,153733800,128733800,1,19531235,2014,514.9352
2167,68,1992-11-25,The Bodyguard,25000000,121945720,410899039,385899039,11,288953319,1992,1543.596156
2168,69,1993-12-15,Schindlerâs List,25000000,96898818,322197132,297197132,12,225298314,1993,1188.788528
2169,70,2003-07-02,"Legally Blonde 2: Red, White & Blonde",25000000,90639088,125339088,100339088,7,34700000,2003,401.356352
2170,71,2004-03-26,Scooby-Doo 2: Monsters Unleashed,25000000,84185387,181185387,156185387,3,97000000,2004,624.741548
2171,72,2004-07-09,Anchorman: The Legend of Ron Burgundy,25000000,84136909,89476265,64476265,7,5339356,2004,257.90506
2172,73,2003-08-15,Freddy vs. Jason,25000000,82622655,114576403,89576403,8,31953748,2003,358.305612
2173,74,2007-02-16,Bridge to Terabithia,25000000,82234139,137984788,112984788,2,55750649,2007,451.93915200000004
2174,75,2001-12-21,Jimmy Neutron: Boy Genius,25000000,80936232,102992536,77992536,12,22056304,2001,311.970144
2175,76,2008-01-18,Cloverfield,25000000,80048433,171302226,146302226,1,91253793,2008,585.208904
2176,77,2010-02-05,Dear John,25000000,80014842,142033509,117033509,2,62018667,2010,468.13403600000004
2177,78,1991-03-22,Teenage Mutant Ninja Turtles II: The Secret of the Ooze,25000000,78656813,78656813,53656813,3,0,1991,214.627252
2178,79,2012-12-25,Parental Guidance,25000000,77267296,120832383,95832383,12,43565087,2012,383.329532
2179,80,1987-06-03,The Untouchables,25000000,76270454,76270454,51270454,6,0,1987,205.081816
2180,81,2007-11-09,No Country for Old Men,25000000,74273505,164035753,139035753,11,89762248,2007,556.143012
2181,82,2001-04-13,Bridget Jones's Diary,25000000,71500556,281527158,256527158,4,210026602,2001,1026.108632
2182,83,2000-12-15,Chocolat,25000000,71309760,152500343,127500343,12,81190583,2000,510.00137199999995
2183,84,2011-01-21,No Strings Attached,25000000,70662220,149228078,124228078,1,78565858,2011,496.912312
2184,85,2012-01-13,Contraband,25000000,66528000,98406855,73406855,1,31878855,2012,293.62742000000003
2185,86,2017-01-27,A Dogâs Purpose,25000000,64321890,203671625,178671625,1,139349735,2017,714.6865
2186,87,2012-04-20,The Lucky One,25000000,60457138,96633833,71633833,4,36176695,2012,286.535332
2187,88,1993-12-25,Tombstone,25000000,56505065,56505065,31505065,12,0,1993,126.02026
2188,89,2000-03-22,Romeo Must Die,25000000,55973336,91036760,66036760,3,35063424,2000,264.14704
2189,90,2006-06-06,The Omen,25000000,54607383,119295584,94295584,6,64688201,2006,377.182336
2190,91,2006-02-10,Final Destination 3,25000000,54098051,112798051,87798051,2,58700000,2006,351.192204
2191,92,2011-04-22,Madea's Big Happy Family,25000000,53345287,54160818,29160818,4,815531,2011,116.643272
2192,93,2013-12-13,Tyler Perry's A Madea Christmas,25000000,52543354,52543354,27543354,12,0,2013,110.17341599999999
2193,94,2004-11-12,Finding Neverland,25000000,51676606,115036108,90036108,11,63359502,2004,360.144432
2194,95,2012-01-27,The Grey,25000000,51580136,81249176,56249176,1,29669040,2012,224.996704
2195,96,2005-01-28,Hide and Seek,25000000,51100486,123696741,98696741,1,72596255,2005,394.786964
2196,97,1986-05-23,Cobra,25000000,49042224,49042224,24042224,5,0,1986,96.168896
2197,98,2008-08-22,The House Bunny,25000000,48237389,71390601,46390601,8,23153212,2008,185.562404
2198,99,2003-03-14,Agent Cody Banks,25000000,47545060,58240458,33240458,3,10695398,2003,132.96183200000002
2199,100,2006-01-27,Nanny McPhee,25000000,47279279,128745578,103745578,1,81466299,2006,414.982312
2200,1,1990-09-19,Goodfellas,25000000,46743809,46777347,21777347,9,33538,1990,87.109388
2201,2,2014-08-15,The Giver,25000000,45090374,66540205,41540205,8,21449831,2014,166.16082
2202,3,1983-12-09,Scarface,25000000,44942821,44942821,19942821,12,0,1983,79.771284
2203,4,1997-07-18,Nothing To Lose,25000000,44480039,64594061,39594061,7,20114022,1997,158.376244
2204,5,1987-11-20,The Last Emperor,25000000,43984987,44005073,19005073,11,20086,1987,76.020292
2205,6,2015-11-20,The Night Before,25000000,43035725,52427346,27427346,11,9391621,2015,109.70938400000001
2206,7,1993-10-15,The Beverly Hillbillies,25000000,42222647,55598481,30598481,10,13375834,1993,122.393924
2207,8,2002-12-27,The Hours,25000000,41675994,97030468,72030468,12,55354474,2002,288.121872
2208,9,1997-08-22,Money Talks,25000000,41076865,41076865,16076865,8,0,1997,64.30746
2209,10,2007-12-26,There Will Be Blood,25000000,40222514,77208711,52208711,12,36986197,2007,208.83484399999998
2210,11,2002-12-20,The Wild Thornberrys Movie,25000000,40108697,60694737,35694737,12,20586040,2002,142.77894799999999
2211,12,2003-06-13,Rugrats Go Wild,25000000,39402572,55443032,30443032,6,16040460,2003,121.772128
2212,13,2005-06-01,The Sisterhood of the Traveling Pants,25000000,39053061,41560117,16560117,6,2507056,2005,66.24046799999999
2213,14,2002-05-31,Undercover Brother,25000000,38230435,40796145,15796145,5,2565710,2002,63.184580000000004
2214,15,2013-12-25,August: Osage County,25000000,37738810,50738810,25738810,12,13000000,2013,102.95524
2215,16,2001-07-06,Kiss of the Dragon,25000000,36833473,36833473,11833473,7,0,2001,47.333892
2216,17,2014-05-16,Million Dollar Arm,25000000,36447959,39217912,14217912,5,2769953,2014,56.87164799999999
2217,18,2004-01-01,Beauty Shop,25000000,36351350,38351350,13351350,1,2000000,2004,53.4054
2218,19,2003-04-04,What a Girl Wants,25000000,35990505,35990505,10990505,4,0,2003,43.96202
2219,20,2003-08-29,Jeepers Creepers II,25000000,35623801,119923801,94923801,8,84300000,2003,379.695204
2220,21,2018-09-07,Peppermint,25000000,35418723,51800758,26800758,9,16382035,2018,107.20303200000001
2221,22,2007-09-21,Good Luck Chuck,25000000,35017297,59183821,34183821,9,24166524,2007,136.73528399999998
2222,23,2003-02-28,Cradle 2 the Grave,25000000,34657731,56434942,31434942,2,21777211,2003,125.739768
2223,24,2006-03-17,She's the Man,25000000,33889159,55279608,30279608,3,21390449,2006,121.11843200000001
2224,25,2014-12-10,The Gambler,25000000,33680992,38718031,13718031,12,5037039,2014,54.872124
2225,26,2007-08-24,Mr. Beanâs Holiday,25000000,33302167,234981342,209981342,8,201679175,2007,839.9253679999999
2226,27,2016-04-29,Motherâs Day,25000000,32492859,52367022,27367022,4,19874163,2016,109.46808800000001
2227,28,1998-10-16,Bride of Chucky,25000000,32404188,50692188,25692188,10,18288000,1998,102.76875199999999
2228,29,2017-02-17,Fist Fight,25000000,32187017,40286416,15286416,2,8099399,2017,61.145664
2229,30,2007-11-21,August Rush,25000000,31664162,65882103,40882103,11,34217941,2007,163.528412
2230,31,2004-08-27,Anacondas: The Hunt for the Blood Orchid,25000000,31526393,70326393,45326393,8,38800000,2004,181.30557199999998
2231,32,2011-12-09,The Sitter,25000000,30542576,38749404,13749404,12,8206828,2011,54.99761600000001
2232,33,1998-11-06,Elizabeth,25000000,30082699,82150642,57150642,11,52067943,1998,228.602568
2233,34,1970-09-23,"Tora, Tora, Tora",25000000,29548291,29548291,4548291,9,0,1970,18.193164
2234,35,1998-01-23,Spice World,25000000,29342592,56042592,31042592,1,26700000,1998,124.17036800000001
2235,36,2014-04-11,Draft Day,25000000,28842237,29847480,4847480,4,1005243,2014,19.38992
2236,37,1994-09-23,The Shawshank Redemption,25000000,28241469,28307092,3307092,9,65623,1994,13.228367999999998
2237,38,2017-02-03,Rings,25000000,27793018,82917283,57917283,2,55124265,2017,231.669132
2238,39,2009-05-22,Dance Flick,25000000,25794018,32224624,7224624,5,6430606,2009,28.898496
2239,40,2001-04-20,Crocodile Dundee in Los Angeles,25000000,25590119,39393111,14393111,4,13802992,2001,57.572444
2240,41,1996-07-26,Kingpin,25000000,25023424,32223424,7223424,7,7200000,1996,28.893696000000002
2241,42,2005-03-18,Ice Princess,25000000,24381334,25732334,732334,3,1351000,2005,2.929336
2242,43,2011-08-26,Don't Be Afraid of the Dark,25000000,24046682,39126427,14126427,8,15079745,2011,56.505708
2243,44,2010-04-23,The Losers,25000000,23591432,29863840,4863840,4,6272408,2010,19.45536
2244,45,2009-04-24,Fighting,25000000,23091010,32831707,7831707,4,9740697,2009,31.326828000000003
2245,46,2007-08-24,War,25000000,22486409,40686409,15686409,8,18200000,2007,62.745636000000005
2246,47,1995-04-07,Don Juan DeMarco,25000000,22032635,22032635,-2967365,4,0,1995,-11.86946
2247,48,2005-04-22,A Lot Like Love,25000000,21835784,41921590,16921590,4,20085806,2005,67.68636000000001
2248,49,1998-05-01,He Got Game,25000000,21567853,22411948,-2588052,5,844095,1998,-10.352208000000001
2249,50,2011-02-11,The Eagle,25000000,19490041,38993548,13993548,2,19503507,2011,55.974192
2250,51,2015-08-05,Shaun the Sheep,25000000,19375982,101925161,76925161,8,82549179,2015,307.700644
2251,52,2011-09-02,Shark Night 3D,25000000,18877153,18877153,-6122847,9,0,2011,-24.491388
2252,53,2017-03-24,CHiPS,25000000,18600152,23190292,-1809708,3,4590140,2017,-7.238832
2253,54,2002-10-11,Punch-Drunk Love,25000000,17791031,24591031,-408969,10,6800000,2002,-1.635876
2254,55,2004-02-20,Eurotrip,25000000,17718223,20718223,-4281777,2,3000000,2004,-17.127108
2255,56,2017-12-22,Father Figures,25000000,17501244,21038441,-3961559,12,3537197,2017,-15.846236
2256,57,2008-04-04,The Ruins,25000000,17432844,22910563,-2089437,4,5477719,2008,-8.357747999999999
2257,58,2013-10-25,The Counselor,25000000,16973715,71009334,46009334,10,54035619,2013,184.037336
2258,59,2006-12-08,Unaccompanied Minors,25000000,16655224,21970831,-3029169,12,5315607,2006,-12.116676
2259,60,2018-12-07,Mary Queen of Scots,25000000,16468499,46734733,21734733,12,30266234,2018,86.93893200000001
2260,61,1988-04-01,"Bright Lights, Big City",25000000,16118077,16118077,-8881923,4,0,1988,-35.527692
2261,62,2002-11-15,Half Past Dead,25000000,15567860,19233280,-5766720,11,3665420,2002,-23.06688
2262,63,1986-04-18,Legend,25000000,15502112,23506237,-1493763,4,8004125,1986,-5.975052
2263,64,1996-07-26,The Adventures of Pinocchio,25000000,15382170,36682170,11682170,7,21300000,1996,46.72868
2264,65,2005-09-30,The Greatest Game Ever Played,25000000,15331289,15468266,-9531734,9,136977,2005,-38.126936
2265,66,2009-11-06,The Box,25000000,15051977,34356760,9356760,11,19304783,2009,37.42704
2266,67,2000-03-03,The Next Best Thing,25000000,14983572,24355762,-644238,3,9372190,2000,-2.576952
2267,68,2010-10-08,My Soul to Take,25000000,14744435,16727470,-8272530,10,1983035,2010,-33.09012
2268,69,2004-04-09,The Girl Next Door,25000000,14589444,31635150,6635150,4,17045706,2004,26.540599999999998
2269,70,2008-08-15,Fly Me To the Moon,25000000,14543943,43530281,18530281,8,28986338,2008,74.12112400000001
2270,71,1996-09-13,Maximum Risk,25000000,14102929,51702929,26702929,9,37600000,1996,106.81171599999999
2271,72,2002-09-13,Stealing Harvard,25000000,13973532,13973532,-11026468,9,0,2002,-44.105872000000005
2272,73,2007-08-03,Hot Rod,25000000,13938332,14334401,-10665599,8,396069,2007,-42.662396
2273,74,2011-09-09,Warrior,25000000,13657115,24215385,-784615,9,10558270,2011,-3.13846
2274,75,1999-12-24,Angela's Ashes,25000000,13038660,13038660,-11961340,12,0,1999,-47.84536
2275,76,2017-09-22,Battle of the Sexes,25000000,12638526,18445379,-6554621,9,5806853,2017,-26.218483999999997
2276,77,2012-12-21,Cirque du Soleil: Worlds Away,25000000,12512862,28012862,3012862,12,15500000,2012,12.051447999999999
2277,78,2015-11-13,The 33,25000000,12227722,28400715,3400715,11,16172993,2015,13.60286
2278,79,1985-06-21,Lifeforce,25000000,11603545,11603545,-13396455,6,0,1985,-53.58582
2279,80,2011-04-15,The Conspirator,25000000,11538204,15907411,-9092589,4,4369207,2011,-36.370356
2280,81,2002-07-03,The Powerpuff Girls,25000000,11411644,16425701,-8574299,7,5014057,2002,-34.297196
2281,82,2005-06-03,The Lords of Dogtown,25000000,11273517,13424365,-11575635,6,2150848,2005,-46.30254
2282,83,1986-07-01,Big Trouble in Little China,25000000,11100000,11100000,-13900000,7,0,1986,-55.60000000000001
2283,84,1996-10-11,Michael Collins,25000000,11092559,27572844,2572844,10,16480285,1996,10.291376000000001
2284,85,2008-03-28,Stop-Loss,25000000,10915744,11229035,-13770965,3,313291,2008,-55.083859999999994
2285,86,1993-10-08,Gettysburg,25000000,10731997,10731997,-14268003,10,0,1993,-57.07201200000001
2286,87,2002-10-18,Abandon,25000000,10719367,12219367,-12780633,10,1500000,2002,-51.122532
2287,88,2011-09-16,Straw Dogs,25000000,10324441,11253821,-13746179,9,929380,2011,-54.984716
2288,89,1999-08-13,Brokedown Palace,25000000,10115014,11115766,-13884234,8,1000752,1999,-55.536936000000004
2289,90,2002-08-16,Possession,25000000,10103647,14805812,-10194188,8,4702165,2002,-40.776752
2290,91,1996-04-19,Mrs. Winterbourne,25000000,10039566,10039566,-14960434,4,0,1996,-59.841736
2291,92,1991-05-17,Stone Cold,25000000,9286314,9286314,-15713686,5,0,1991,-62.854744
2292,93,2019-01-25,Serenity,25000000,8547045,11367029,-13632971,1,2819984,2019,-54.531884
2293,94,2009-11-25,The Road,25000000,8114270,29206732,4206732,11,21092462,2009,16.826928
2294,95,2018-10-12,Beautiful Boy,25000000,7634767,13031424,-11968576,10,5396657,2018,-47.874304
2295,96,2007-04-06,The Hoax,25000000,7164995,7164995,-17835005,4,0,2007,-71.34002000000001
2296,97,2019-03-15,Captive State,25000000,5958315,8993300,-16006700,3,3034985,2019,-64.0268
2297,98,1984-08-17,Sheena,25000000,5778353,5778353,-19221647,8,0,1984,-76.886588
2298,99,2005-09-02,Underclassman,25000000,5654777,5654777,-19345223,9,0,2005,-77.380892
2299,100,2001-03-23,Say It Isn't So,25000000,5516708,5516708,-19483292,3,0,2001,-77.933168
2300,1,2005-12-07,The World's Fastest Indian,25000000,5128124,18991288,-6008712,12,13863164,2005,-24.034848
2301,2,2008-04-25,Deception,25000000,4598506,12850033,-12149967,4,8251527,2008,-48.599868
2302,3,1995-03-01,Tank Girl,25000000,4064333,4064333,-20935667,3,0,1995,-83.742668
2303,4,2005-04-22,King's Ransom,25000000,4008527,4049527,-20950473,4,41000,2005,-83.801892
2304,5,2008-10-03,Blindness,25000000,3073392,20052958,-4947042,10,16979566,2008,-19.788168
2305,6,2018-04-13,Sgt. Stubby: An American Hero,25000000,3054285,3645957,-21354043,4,591672,2018,-85.416172
2306,7,2011-12-16,Carnage,25000000,2546747,38112154,13112154,12,35565407,2011,52.448616
2307,8,2017-09-01,Tulip Fever,25000000,2455635,6792768,-18207232,9,4337133,2017,-72.828928
2308,9,2006-01-06,BloodRayne,25000000,2405420,3711633,-21288367,1,1306213,2006,-85.153468
2309,10,2015-11-20,Legend,25000000,1872994,42425450,17425450,11,40552456,2015,69.7018
2310,11,2009-11-20,Bad Lieutenant: Port of Call New Orleans,25000000,1702112,12413949,-12586051,11,10711837,2009,-50.344204000000005
2311,12,2016-01-29,Jane Got a Gun,25000000,1513793,3771345,-21228655,1,2257552,2016,-84.91462
2312,13,2009-11-25,Me and Orson Welles,25000000,1190003,1190003,-23809997,11,0,2009,-95.239988
2313,14,2005-09-16,Venom,25000000,881745,881745,-24118255,9,0,2005,-96.47301999999999
2314,15,2005-10-14,Where the Truth Lies,25000000,872142,1415656,-23584344,10,543514,2005,-94.33737599999999
2315,16,1998-09-11,Without Limits,25000000,780326,780326,-24219674,9,0,1998,-96.87869599999999
2316,17,2013-03-22,On the Road,25000000,720828,9313302,-15686698,3,8592474,2013,-62.746792
2317,18,2012-08-24,Les petits mouchoirs,25000000,205505,48530887,23530887,8,48325382,2012,94.123548
2318,19,2010-06-30,Love Ranch,25000000,137885,146149,-24853851,6,8264,2010,-99.415404
2319,20,2015-04-24,Yi ge ren de wu lin,25000000,129115,129115,-24870885,4,0,2015,-99.48354
2320,21,2010-12-31,Sammy's avonturen: De geheime doorgang,25000000,0,71594792,46594792,12,71594792,2010,186.379168
2321,22,2010-12-31,Belka i Strelka. Zvezdnye sobaki,25000000,0,9445081,-15554919,12,9445081,2010,-62.219676
2322,23,2017-12-31,Matilda,25000000,0,9370285,-15629715,12,9370285,2017,-62.51886
2323,24,2011-10-04,La vÃ©ritable histoire du Chat BottÃ©,25000000,0,8208594,-16791406,10,8208594,2011,-67.16562400000001
2324,25,2011-07-08,Ironclad,25000000,0,5297411,-19702589,7,5297411,2011,-78.810356
2325,26,2019-05-10,The Professor and the Madman,25000000,0,5227233,-19772767,5,5227233,2019,-79.09106799999999
2326,27,2015-03-10,Red Sky,25000000,0,91116,-24908884,3,91116,2015,-99.635536
2327,28,1970-01-01,Waterloo,25000000,0,0,-25000000,1,0,1970,-100.0
2328,29,2014-01-10,The Adventurer: The Curse of the Midas Box,25000000,0,0,-25000000,1,0,2014,-100.0
2329,30,2019-12-31,Reagan,25000000,0,0,-25000000,12,0,2019,-100.0
2330,31,2012-11-09,Dangerous Liaisons,24200000,17000,10447579,-13752421,11,10430579,2012,-56.82818595041322
2331,32,1986-11-26,Star Trek IV: The Voyage Home,24000000,109713132,133000000,109000000,11,23286868,1986,454.1666666666667
2332,33,1997-12-12,Scream 2,24000000,101363301,172363301,148363301,12,71000000,1997,618.1804208333333
2333,34,2003-02-21,Old School,24000000,75155000,86765463,62765463,2,11610463,2003,261.5227625
2334,35,2006-12-20,Rocky Balboa,24000000,70269899,156229050,132229050,12,85959151,2006,550.954375
2335,36,2014-06-20,Think Like a Man Too,24000000,65028687,70027933,46027933,6,4999246,2014,191.7830541666667
2336,37,2016-12-16,Fences,24000000,57682904,64282881,40282881,12,6599977,2016,167.8453375
2337,38,2000-02-18,The Whole Nine Yards,24000000,57262492,85527867,61527867,2,28265375,2000,256.3661125
2338,39,2011-10-14,Footloose,24000000,51802742,62989834,38989834,10,11187092,2011,162.4576416666667
2339,40,2017-04-07,Going in Style,24000000,45018541,78672579,54672579,4,33654038,2017,227.8024125
2340,41,1991-07-12,Point Break,24000000,43218387,83531958,59531958,7,40313571,1991,248.049825
2341,42,1991-09-20,The Fisher King,24000000,41798224,41798224,17798224,9,0,1991,74.15926666666667
2342,43,1998-11-13,I Still Know What You Did Last Summer,24000000,40020622,40020622,16020622,11,0,1998,66.75259166666667
2343,44,2007-11-21,Hitman,24000000,39687694,99135571,75135571,11,59447877,2007,313.0648791666667
2344,45,1969-12-16,"Hello, Dolly",24000000,33208099,33208099,9208099,12,0,1969,38.36707916666667
2345,46,2000-04-07,Return to Me,24000000,32662299,32662299,8662299,4,0,2000,36.092912500000004
2346,47,2009-11-06,The Men Who Stare at Goats,24000000,32428195,67348218,43348218,11,34920023,2009,180.617575
2347,48,2008-10-31,Zack and Miri Make a Porno,24000000,31457946,36856306,12856306,10,5398360,2008,53.56794166666666
2348,49,2001-01-12,Double Take,24000000,29823162,29823162,5823162,1,0,2001,24.263175
2349,50,1999-12-21,"Girl, Interrupted",24000000,28871190,28871190,4871190,12,0,1999,20.296625
2350,51,2000-09-08,Nurse Betty,24000000,25170054,27732366,3732366,9,2562312,2000,15.551525
2351,52,2010-08-20,Piranha 3D,24000000,25003155,83660160,59660160,8,58657005,2010,248.584
2352,53,2010-11-24,Faster,24000000,23240020,35792945,11792945,11,12552925,2010,49.13727083333333
2353,54,1978-10-24,The Wiz,24000000,22000000,22000000,-2000000,10,0,1978,-8.333333333333332
2354,55,2004-01-23,Win a Date with Tad Hamilton!,24000000,16980098,16980098,-7019902,1,0,2004,-29.249591666666667
2355,56,1999-07-14,Muppets From Space,24000000,16304786,16304786,-7695214,7,0,1999,-32.06339166666667
2356,57,2000-04-07,Ready to Rumble,24000000,12372410,12372410,-11627590,4,0,2000,-48.44829166666666
2357,58,2011-09-16,I Don't Know How She Does It,24000000,9659074,24474463,474463,9,14815389,2011,1.9769291666666668
2358,59,1999-12-24,Play it to the Bone,24000000,8427204,8427204,-15572796,12,0,1999,-64.88665
2359,60,2013-12-20,Dhoom 3,24000000,8031955,11723620,-12276380,12,3691665,2013,-51.15158333333333
2360,61,2004-12-17,Beyond the Sea,24000000,6144806,8292914,-15707086,12,2148108,2004,-65.44619166666666
2361,62,2005-06-10,Hauru no ugoku shiro,24000000,4710455,237814327,213814327,6,233103872,2005,890.8930291666668
2362,63,1998-03-27,Meet the Deedles,24000000,4356126,4356126,-19643874,3,0,1998,-81.849475
2363,64,1995-08-25,The Thief and the Cobbler,24000000,669276,669276,-23330724,8,0,1995,-97.21135
2364,65,2005-06-10,The Bridge of San Luis Rey,24000000,49981,1696765,-22303235,6,1646784,2005,-92.93014583333333
2365,66,2007-12-31,Flood,24000000,0,4084232,-19915768,12,4084232,2007,-82.98236666666666
2366,67,2009-10-02,Zombieland,23600000,75590286,102236596,78636596,10,26646310,2009,333.2059152542373
2367,68,1980-05-21,Star Wars Ep. V: The Empire Strikes Back,23000000,290271960,534161334,511161334,5,243889374,1980,2222.440582608696
2368,69,1998-11-06,The Waterboy,23000000,161491646,190191646,167191646,11,28700000,1998,726.9202
2369,70,1991-06-28,The Naked Gun 2Â½: The Smell of Fear,23000000,86930411,86930411,63930411,6,0,1991,277.9583086956522
2370,71,2018-11-16,Green Book,23000000,85080171,322034439,299034439,11,236954268,2018,1300.1497347826087
2371,72,1995-04-07,Bad Boys,23000000,65647413,141247413,118247413,4,75600000,1995,514.1191869565217
2372,73,2015-01-16,The Wedding Ringer,23000000,64460211,80171596,57171596,1,15711385,2015,248.57215652173915
2373,74,2000-03-17,Final Destination,23000000,53302314,112036870,89036870,3,58734556,2000,387.1168260869565
2374,75,1976-12-17,King Kong,23000000,52614445,90614445,67614445,12,38000000,1976,293.9758478260869
2375,76,2011-10-07,The Ides of March,23000000,40962534,77735925,54735925,10,36773391,2011,237.98228260869564
2376,77,2000-02-18,Pitch Black,23000000,39235088,53182088,30182088,2,13947000,2000,131.2264695652174
2377,78,2018-10-05,The Hate U Give,23000000,29719483,35067665,12067665,10,5348182,2018,52.46810869565217
2378,79,2001-03-30,Someone Like You,23000000,27338033,38684906,15684906,3,11346873,2001,68.19524347826086
2379,80,2014-01-10,Her,23000000,25568251,48163815,25163815,1,22595564,2014,109.40789130434783
2380,81,2001-10-05,Joy Ride,23000000,21973182,21973182,-1026818,10,0,2001,-4.4644260869565215
2381,82,2012-02-17,Kari gurashi no Arietti,23000000,19192510,151496097,128496097,2,132303587,2012,558.6786826086956
2382,83,2012-01-20,Haywire,23000000,18942396,36374700,13374700,1,17432304,2012,58.15086956521739
2383,84,1999-11-12,Anywhere But Here,23000000,18653615,18653615,-4346385,11,0,1999,-18.89732608695652
2384,85,2004-09-01,Vanity Fair,23000000,16123851,19123851,-3876149,9,3000000,2004,-16.852821739130437
2385,86,2016-02-26,Eddie the Eagle,23000000,15789389,45060480,22060480,2,29271091,2016,95.91513043478261
2386,87,1987-07-17,Jaws 4: The Revenge,23000000,15728335,15728335,-7271665,7,0,1987,-31.615934782608697
2387,88,2000-08-25,The Crew,23000000,13019253,13019253,-9980747,8,0,2000,-43.39455217391304
2388,89,1996-12-20,Marvin's Room,23000000,12803305,12803305,-10196695,12,0,1996,-44.33345652173913
2389,90,2004-01-09,Chasing Liberty,23000000,12189514,12291975,-10708025,1,102461,2004,-46.55663043478261
2390,91,2008-08-22,The Longshots,23000000,11511323,11778396,-11221604,8,267073,2008,-48.78958260869565
2391,92,1999-12-03,The End of the Affair,23000000,10660147,10660147,-12339853,12,0,1999,-53.6515347826087
2392,93,1991-08-23,Harley Davidson and the Marlboro Man,23000000,7018525,7018525,-15981475,8,0,1991,-69.48467391304348
2393,94,2007-09-14,In the Valley of Elah,23000000,6777741,24489150,1489150,9,17711409,2007,6.474565217391303
2394,95,2009-09-25,Coco avant Chanel,23000000,6113834,50813834,27813834,9,44700000,2009,120.92971304347826
2395,96,2009-06-26,ChÃ©ri,23000000,2715657,2715657,-20284343,6,0,2009,-88.19279565217391
2396,97,2013-06-28,Redemption,23000000,36686,13593473,-9406527,6,13556787,2013,-40.89794347826087
2397,98,2008-04-25,Rogue,23000000,10452,4673377,-18326623,4,4662925,2008,-79.6809695652174
2398,99,2017-05-05,ChÄi dÃ n zhuÄnjiÄ,23000000,0,58807172,35807172,5,58807172,2017,155.6833565217391
2399,100,2011-03-15,Shi Yue Wei Cheng,23000000,0,44195779,21195779,3,44195779,2011,92.15556086956522
2400,1,1987-06-24,Spaceballs,22700000,38119483,38119483,15419483,6,0,1987,67.92723788546256
2401,2,2007-06-22,1408,22500000,71985628,131263370,108763370,6,59277742,2007,483.39275555555554
2402,3,2016-11-18,Nocturnal Animals,22500000,10663357,32398681,9898681,11,21735324,2016,43.99413777777777
2403,4,2015-04-24,The Water Diviner,22500000,4200117,31054727,8554727,4,26854610,2015,38.02100888888889
2404,5,1990-07-13,Ghost,22000000,217631306,517600000,495600000,7,299968694,1990,2252.7272727272725
2405,6,1998-07-15,There's Something About Mary,22000000,176484651,369884651,347884651,7,193400000,1998,1581.2938681818182
2406,7,1994-11-11,The Santa Clause,22000000,144833357,189800000,167800000,11,44966643,1994,762.7272727272727
2407,8,2007-09-28,The Game Plan,22000000,90648202,146590987,124590987,9,55942785,2007,566.3226681818182
2408,9,2002-03-29,The Rookie,22000000,75600072,80491516,58491516,3,4891444,2002,265.87052727272726
2409,10,1995-06-02,The Bridges of Madison County,22000000,71516617,175516617,153516617,6,104000000,1995,697.8028045454545
2410,11,2014-02-28,Son of God,22000000,59700064,70949793,48949793,2,11249729,2014,222.4990590909091
2411,12,2001-06-01,The Animal,22000000,55762229,55762229,33762229,6,0,2001,153.46467727272727
2412,13,2014-08-08,The Hundred-Foot Journey,22000000,54235441,94270488,72270488,8,40035047,2014,328.5022181818182
2413,14,1982-12-08,Gandhi,22000000,52767889,127767889,105767889,12,75000000,1982,480.7631318181818
2414,15,2003-09-19,Underworld,22000000,51970690,95708457,73708457,9,43737767,2003,335.0384409090909
2415,16,1995-07-28,The Net,22000000,50621733,110521733,88521733,7,59900000,1995,402.3715136363636
2416,17,2012-08-03,Diary of a Wimpy Kid: Dog Days,22000000,49008662,77229695,55229695,8,28221033,2012,251.0440681818182
2417,18,2001-12-28,I Am Sam,22000000,40270895,92542418,70542418,12,52271523,2001,320.64735454545456
2418,19,2005-11-11,Derailed,22000000,36020063,57520063,35520063,11,21500000,2005,161.45483181818182
2419,20,2009-09-18,The Informant!,22000000,33316821,41771168,19771168,9,8454347,2009,89.86894545454545
2420,21,2013-11-22,Delivery Man,22000000,30659817,70536870,48536870,11,39877053,2013,220.62213636363634
2421,22,2016-02-05,"Hail, Caesar!",22000000,30080225,64160680,42160680,2,34080455,2016,191.63945454545456
2422,23,2001-08-24,Jay and Silent Bob Strike Back,22000000,30059386,33762400,11762400,8,3703014,2001,53.46545454545455
2423,24,1993-12-29,Shadowlands,22000000,25842377,25842377,3842377,12,0,1993,17.465349999999997
2424,25,2008-08-27,Traitor,22000000,23530831,27882226,5882226,8,4351395,2008,26.73739090909091
2425,26,2005-08-12,Deuce Bigalow: European Gigolo,22000000,22400154,45273464,23273464,8,22873310,2005,105.78847272727272
2426,27,2017-05-19,Diary of a Wimpy Kid: The Long Haul,22000000,20738724,35609577,13609577,5,14870853,2017,61.86171363636363
2427,28,2008-01-18,Mad Money,22000000,20668843,25044057,3044057,1,4375214,2008,13.836622727272726
2428,29,2013-11-27,Homefront,22000000,20158492,51695362,29695362,11,31536870,2013,134.9789181818182
2429,30,2008-09-19,Igor,22000000,19528602,31013349,9013349,9,11484747,2008,40.96976818181818
2430,31,2001-02-09,Saving Silverman,22000000,19351569,25873142,3873142,2,6521573,2001,17.605190909090908
2431,32,1999-07-02,Summer of Sam,22000000,19288130,19288130,-2711870,7,0,1999,-12.326681818181818
2432,33,2001-09-14,The Glass House,22000000,17951431,22861785,861785,9,4910354,2001,3.9172045454545454
2433,34,2015-09-04,The Transporter Refueled,22000000,16029670,69698495,47698495,9,53668825,2015,216.81134090909092
2434,35,1980-06-13,The Island,22000000,15716828,15716828,-6283172,6,0,1980,-28.55987272727273
2435,36,2001-04-11,Josie and the Pussycats,22000000,14252830,14252830,-7747170,4,0,2001,-35.21440909090909
2436,37,2012-08-22,Hit & Run,22000000,13749300,17216955,-4783045,8,3467655,2012,-21.741113636363636
2437,38,2000-10-27,The Little Vampire,22000000,13555988,13555988,-8444012,10,0,2000,-38.38187272727273
2438,39,2004-10-01,I Heart Huckabees,22000000,12784713,20034713,-1965287,10,7250000,2004,-8.933122727272726
2439,40,2017-11-17,"Roman J. Israel, Esq.",22000000,11962712,12967012,-9032988,11,1004300,2017,-41.059036363636366
2440,41,2013-12-04,Out of the Furnace,22000000,11330849,15434375,-6565625,12,4103526,2013,-29.843750000000004
2441,42,1993-11-05,RoboCop 3,22000000,10696210,10696210,-11303790,11,0,1993,-51.380863636363635
2442,43,1999-08-27,Dudley Do-Right,22000000,9818792,9818792,-12181208,8,0,1999,-55.36912727272727
2443,44,2017-12-08,Just Getting Started,22000000,6069605,6756412,-15243588,12,686807,2017,-69.28903636363636
2444,45,2001-09-21,Megiddo: Omega Code 2,22000000,6047691,6047691,-15952309,9,0,2001,-72.51049545454545
2445,46,1970-01-01,Darling Lili,22000000,5000000,5000000,-17000000,1,0,1970,-77.27272727272727
2446,47,2005-11-23,The Libertine,22000000,4835065,9448623,-12551377,11,4613558,2005,-57.05171363636363
2447,48,2007-04-06,Zwartboek,22000000,4398532,27238354,5238354,4,22839822,2007,23.8107
2448,49,2014-10-31,Before I Go to Sleep,22000000,3242457,19563579,-2436421,10,16321122,2014,-11.07464090909091
2449,50,2010-10-08,Stone,22000000,1810078,4065020,-17934980,10,2254942,2010,-81.52263636363635
2450,51,2006-03-03,Joyeux NoÃ«l,22000000,1054361,23134075,1134075,3,22079714,2006,5.154886363636364
2451,52,2013-12-31,Metegol,22000000,0,34061097,12061097,12,34061097,2013,54.82316818181818
2452,53,1977-06-24,Sorcerer,21600000,12000000,12005968,-9594032,6,5968,1977,-44.41681481481481
2453,54,2007-07-27,MoliÃ¨re,21600000,635733,791154,-20808846,7,155421,2007,-96.33725
2454,55,2007-10-05,Michael Clayton,21500000,49033882,92987651,71487651,10,43953769,2007,332.5007023255814
2455,56,1999-07-09,Arlington Road,21500000,24419219,24419219,2919219,7,0,1999,13.577762790697676
2456,57,1996-12-20,My Fellow Americans,21500000,22331846,22331846,831846,12,0,1996,3.869051162790697
2457,58,2012-06-22,To Rome with Love,21500000,16684352,74326015,52826015,6,57641663,2012,245.70239534883723
2458,59,2012-11-16,Silver Linings Playbook,21000000,132092958,236412453,215412453,11,104319495,2012,1025.7735857142857
2459,60,2018-04-06,Blockers,21000000,60311495,94045328,73045328,4,33733833,2018,347.8348952380952
2460,61,2019-04-05,Pet Sematary,21000000,54724696,109501146,88501146,4,54776450,2019,421.4340285714286
2461,62,1999-06-30,"South Park: Bigger, Longer & Uncut",21000000,52037603,52037603,31037603,6,0,1999,147.79810952380953
2462,63,1982-06-18,Firefox,21000000,45785720,45785720,24785720,6,0,1982,118.02723809523809
2463,64,2010-04-16,Death at a Funeral,21000000,42739347,48977233,27977233,4,6237886,2010,133.22491904761904
2464,65,1993-03-19,Teenage Mutant Ninja Turtles III,21000000,42273609,42273609,21273609,3,0,1993,101.3029
2465,66,2001-09-14,Hardball,21000000,40222729,43728560,22728560,9,3505831,2001,108.2312380952381
2466,67,2010-11-05,For Colored Girls,21000000,37729698,38017873,17017873,11,288175,2010,81.03749047619047
2467,68,2007-01-05,Freedom Writers,21000000,36605602,43632609,22632609,1,7027007,2007,107.77432857142857
2468,69,2017-08-04,Kidnap,21000000,30718107,34836080,13836080,8,4117973,2017,65.88609523809524
2469,70,2002-10-11,The Transporter,21000000,25296447,43928932,22928932,10,18632485,2002,109.18539047619046
2470,71,2008-03-14,Never Back Down,21000000,24850922,39319801,18319801,3,14468879,2008,87.23714761904762
2471,72,2011-12-09,Tinker Tailor Soldier Spy,21000000,24149393,81452811,60452811,12,57303418,2011,287.87052857142857
2472,73,2017-09-22,Victoria and Abdul,21000000,22245070,68271146,47271146,9,46026076,2017,225.10069523809523
2473,74,1999-11-05,The Bachelor,21000000,21731001,36882378,15882378,11,15151377,1999,75.63037142857144
2474,75,1999-03-12,The Rage: Carrie 2,21000000,17760244,17760244,-3239756,3,0,1999,-15.427409523809525
2475,76,2008-08-01,Swing Vote,21000000,16289867,17589867,-3410133,8,1300000,2008,-16.23872857142857
2476,77,2009-06-05,Away We Go,21000000,9451946,10108016,-10891984,6,656070,2009,-51.866590476190474
2477,78,2002-09-27,Moonlight Mile,21000000,6830957,6830957,-14169043,9,0,2002,-67.47163333333333
2478,79,2011-05-06,The Beaver,21000000,970816,5046038,-15953962,5,4075222,2011,-75.97124761904762
2479,80,2017-02-24,Bitter Harvest,21000000,557241,606162,-20393838,2,48921,2017,-97.11351428571429
2480,81,1999-10-22,Molly,21000000,17396,17396,-20982604,10,0,1999,-99.91716190476191
2481,82,2019-02-01,Velvet Buzzsaw,21000000,0,0,-21000000,2,0,2019,-100.0
2482,83,1999-04-23,eXistenZ,20700000,2840417,2840417,-17859583,4,0,1999,-86.27817874396135
2483,84,1982-07-23,The Best Little Whorehouse in Texas,20500000,69701637,69701637,49201637,7,0,1982,240.00798536585367
2484,85,2006-08-11,Pulse,20500000,20264436,30241435,9741435,8,9976999,2006,47.51919512195122
2485,86,1991-11-13,Beauty and the Beast,20000000,376057266,608431132,588431132,11,232373866,1991,2942.15566
2486,87,1981-06-12,Raiders of the Lost Ark,20000000,225686079,367452079,347452079,6,141766000,1981,1737.2603949999998
2487,88,2019-03-22,Us,20000000,175006930,254210310,234210310,3,79203380,2019,1171.05155
2488,89,1992-11-20,Home Alone 2: Lost in New York,20000000,173585516,358994850,338994850,11,185409334,1992,1694.97425
2489,90,1977-11-16,Close Encounters of the Third Kind,20000000,169100479,340800479,320800479,11,171700000,1977,1604.0023949999998
2490,91,1987-05-20,Beverly Hills Cop II,20000000,153665036,276665036,256665036,5,123000000,1987,1283.3251799999998
2491,92,2016-12-09,La La Land,20000000,151101803,426351163,406351163,12,275249360,2016,2031.755815
2492,93,2013-07-19,The Conjuring,20000000,137400141,318000141,298000141,7,180600000,2013,1490.000705
2493,94,2003-03-07,Bringing Down the House,20000000,132675402,164675402,144675402,3,32000000,2003,723.37701
2494,95,2017-11-17,Wonder,20000000,132422809,304604712,284604712,11,172181903,2017,1423.02356
2495,96,1991-02-14,The Silence of the Lambs,20000000,130726716,275726716,255726716,2,145000000,1991,1278.63358
2496,97,1992-02-14,Wayne's World,20000000,121697323,183097323,163097323,2,61400000,1992,815.486615
2497,98,2010-10-15,Jackass 3D,20000000,117229692,171685793,151685793,10,54456101,2010,758.428965
2498,99,2016-07-29,Bad Moms,20000000,113257297,180998716,160998716,7,67741419,2016,804.9935800000001
2499,100,2019-01-18,Glass,20000000,111035005,245303505,225303505,1,134268500,2019,1126.517525
2500,1,1978-06-16,Jaws 2,20000000,102922376,208900376,188900376,6,105978000,1978,944.50188
2501,2,2008-10-03,Beverly Hills Chihuahua,20000000,94514402,154218168,134218168,10,59703766,2008,671.09084
2502,3,2014-07-02,Tammy,20000000,84525432,96407655,76407655,7,11882223,2014,382.038275
2503,4,2005-01-21,Are We There Yet?,20000000,82674398,98114471,78114471,1,15440073,2005,390.57235499999996
2504,5,2011-11-16,The Descendants,20000000,82624961,175507800,155507800,11,92882839,2011,777.539
2505,6,2003-10-03,School of Rock,20000000,81261177,131944672,111944672,10,50683495,2003,559.72336
2506,7,2007-04-13,Disturbia,20000000,80818974,118537627,98537627,4,37718653,2007,492.68813500000005
2507,8,1993-07-16,Free Willy,20000000,77698625,153698625,133698625,7,76000000,1993,668.493125
2508,9,2016-10-21,Tyler Perryâs Boo! A Madea Halloween,20000000,73206343,73206343,53206343,10,0,2016,266.031715
2509,10,1995-08-18,Mortal Kombat,20000000,70433227,122133227,102133227,8,51700000,1995,510.66613500000005
2510,11,2004-06-23,White Chicks,20000000,69148997,111448997,91448997,6,42300000,2004,457.244985
2511,12,2009-04-24,Obsessed,20000000,68261644,73964713,53964713,4,5703069,2009,269.823565
2512,13,2003-04-18,Holes,20000000,67383924,71232214,51232214,4,3848290,2003,256.16107
2513,14,2012-06-29,Tyler Perry's Madea's Witness Protection,20000000,65653242,66950887,46950887,6,1297645,2012,234.75443500000003
2514,15,2010-03-31,The Last Song,20000000,62950384,92678948,72678948,3,29728564,2010,363.39473999999996
2515,16,2010-04-02,Why Did I Get Married Too?,20000000,60095852,60831067,40831067,4,735215,2010,204.155335
2516,17,1998-10-23,La vita Ã¨ bella,20000000,57598247,229385361,209385361,10,171787114,1998,1046.926805
2517,18,2013-10-18,12 Years a Slave,20000000,56671993,181025343,161025343,10,124353350,2013,805.1267149999999
2518,19,2002-12-13,Drumline,20000000,56398162,56398162,36398162,12,0,2002,181.99080999999998
2519,20,2016-06-03,Me Before You,20000000,56245075,208265198,188265198,6,152020123,2016,941.32599
2520,21,2019-02-08,What Men Want,20000000,54611903,69911903,49911903,2,15300000,2019,249.55951500000003
2521,22,2016-04-15,Barbershop: The Next Cut,20000000,54030051,54404202,34404202,4,374151,2016,172.02101000000002
2522,23,1990-12-07,Edward Scissorhands,20000000,53976987,53976987,33976987,12,0,1990,169.88493499999998
2523,24,2018-09-14,A Simple Favor,20000000,53548586,97628717,77628717,9,44080131,2018,388.143585
2524,25,2015-01-09,Selma,20000000,52076908,66776576,46776576,1,14699668,2015,233.88288
2525,26,1980-12-12,Popeye,20000000,49823037,49823037,29823037,12,0,1980,149.115185
2526,27,2006-02-17,Date Movie,20000000,48548426,85146165,65146165,2,36597739,2006,325.730825
2527,28,2002-02-15,Peter Pan: Return to Neverland,20000000,48430258,109862682,89862682,2,61432424,2002,449.31341
2528,29,2003-02-14,The Jungle Book 2,20000000,47901582,140122225,120122225,2,92220643,2003,600.611125
2529,30,2007-03-16,Premonition,20000000,47852604,81461343,61461343,3,33608739,2007,307.306715
2530,31,2017-10-20,Tyler Perryâs Boo 2! A Madea Halloween,20000000,47319572,47879572,27879572,10,560000,2017,139.39786
2531,32,2005-02-04,Boogeyman,20000000,46752382,67192859,47192859,2,20440477,2005,235.964295
2532,33,2000-02-11,The Tigger Movie,20000000,45542421,96147688,76147688,2,50605267,2000,380.73844
2533,34,2015-11-06,Spotlight,20000000,45055776,92088460,72088460,11,47032684,2015,360.4423
2534,35,2018-03-30,Acrimony,20000000,43549096,46627836,26627836,3,3078740,2018,133.13918
2535,36,2015-06-26,Max,20000000,42656255,43658157,23658157,6,1001902,2015,118.29078500000001
2536,37,2008-03-21,Meet the Browns,20000000,41975388,41975388,21975388,3,0,2008,109.87693999999999
2537,38,2009-07-24,Orphan,20000000,41596251,78769428,58769428,7,37173177,2009,293.84714
2538,39,2017-11-17,The Star,20000000,40847995,62758010,42758010,11,21910015,2017,213.79005
2539,40,2007-01-26,Epic Movie,20000000,39739367,86858578,66858578,1,47119211,2007,334.29289
2540,41,2008-09-19,Lakeview Terrace,20000000,39263506,44821299,24821299,9,5557793,2008,124.106495
2541,42,2006-10-13,The Grudge 2,20000000,39143839,70743839,50743839,10,31600000,2006,253.71919499999998
2542,43,2016-07-27,Nerve,20000000,38583626,70652284,50652284,7,32068658,2016,253.26142
2543,44,1982-05-14,Conan the Barbarian,20000000,38264085,79114085,59114085,5,40850000,1982,295.570425
2544,45,1998-08-14,How Stella Got Her Groove Back,20000000,37672944,37672944,17672944,8,0,1998,88.36471999999999
2545,46,1991-07-19,Bill & Ted's Bogus Journey,20000000,37537675,37537675,17537675,7,0,1991,87.688375
2546,47,2006-10-13,Man of the Year,20000000,37442180,41342180,21342180,10,3900000,2006,106.71090000000001
2547,48,2016-02-19,Risen,20000000,36880033,46255763,26255763,2,9375730,2016,131.278815
2548,49,2010-08-18,Vampires Suck,20000000,36661504,81424988,61424988,8,44763484,2010,307.12494000000004
2549,50,1979-12-21,The Black Hole,20000000,35841901,35841901,15841901,12,0,1979,79.20950500000001
2550,51,2010-09-01,The American,20000000,35606376,67950723,47950723,9,32344347,2010,239.753615
2551,52,1997-03-21,Selena,20000000,35450113,35450113,15450113,3,0,1997,77.25056500000001
2552,53,2011-11-04,A Very Harold & Kumar 3D Christmas,20000000,35061031,36265745,16265745,11,1204714,2011,81.328725
2553,54,2004-03-19,Eternal Sunshine of the Spotless Mind,20000000,34366518,72570762,52570762,3,38204244,2004,262.85381
2554,55,2013-01-04,Texas Chainsaw 3D,20000000,34341945,47666013,27666013,1,13324068,2013,138.330065
2555,56,2006-10-27,Babel,20000000,34302837,132121212,112121212,10,97818375,2006,560.6060600000001
2556,57,2014-09-19,This is Where I Leave You,20000000,34296320,41296320,21296320,9,7000000,2014,106.4816
2557,58,2008-12-12,Doubt,20000000,33446470,53191101,33191101,12,19744631,2008,165.95550500000002
2558,59,2004-10-15,Team America: World Police,20000000,32774834,50948811,30948811,10,18173977,2004,154.744055
2559,60,1995-10-27,Copycat,20000000,32051917,32051917,12051917,10,0,1995,60.259585
2560,61,2013-04-12,Scary Movie V,20000000,32015787,78613981,58613981,4,46598194,2013,293.069905
2561,62,2010-03-12,She's Out of My League,20000000,32010860,48680977,28680977,3,16670117,2010,143.40488499999998
2562,63,2008-11-26,Milk,20000000,31841299,57293371,37293371,11,25452072,2008,186.466855
2563,64,1969-10-15,Paint Your Wagon,20000000,31678778,31678778,11678778,10,0,1969,58.393890000000006
2564,65,2011-08-31,The Debt,20000000,31177548,46604054,26604054,8,15426506,2011,133.02027
2565,66,2002-10-25,Ghost Ship,20000000,30113491,68349884,48349884,10,38236393,2002,241.74942000000001
2566,67,2010-01-08,Daybreakers,20000000,30101577,51445503,31445503,1,21343926,2010,157.227515
2567,68,2008-03-07,The Bank Job,20000000,30060660,66143005,46143005,3,36082345,2008,230.715025
2568,69,1998-03-20,Wild Things,20000000,29795299,55576699,35576699,3,25781400,1998,177.883495
2569,70,2009-10-16,The Stepfather,20000000,29062561,29227561,9227561,10,165000,2009,46.137805
2570,71,2000-03-31,High Fidelity,20000000,27277055,47881663,27881663,3,20604608,2000,139.408315
2571,72,2006-04-28,Stick It,20000000,26910736,30399714,10399714,4,3488978,2006,51.99857
2572,73,2008-01-04,One Missed Call,20000000,26890041,44513466,24513466,1,17623425,2008,122.56733
2573,74,1996-01-12,Eye for an Eye,20000000,26792700,26792700,6792700,1,0,1996,33.9635
2574,75,2008-04-11,Street Kings,20000000,26418667,65457811,45457811,4,39039144,2008,227.28905500000002
2575,76,2013-08-23,The World's End,20000000,26004851,47508505,27508505,8,21503654,2013,137.54252499999998
2576,77,1996-01-19,From Dusk Till Dawn,20000000,25728961,25732986,5732986,1,4025,1996,28.66493
2577,78,2010-09-24,You Again,20000000,25702053,32838945,12838945,9,7136892,2010,64.19472499999999
2578,79,2007-06-15,Nancy Drew,20000000,25584685,30703845,10703845,6,5119160,2007,53.519225000000006
2579,80,2010-09-17,Alpha and Omega 3D,20000000,25107267,48958353,28958353,9,23851086,2010,144.791765
2580,81,2018-12-25,On the Basis of Sex,20000000,24622687,38073377,18073377,12,13450690,2018,90.366885
2581,82,2014-02-14,Endless Love,20000000,23438250,34718173,14718173,2,11279923,2014,73.59086500000001
2582,83,2006-09-08,The Covenant,20000000,23364784,38164784,18164784,9,14800000,2006,90.82392
2583,84,2011-07-01,Monte Carlo,20000000,23186769,39686769,19686769,7,16500000,2011,98.43384499999999
2584,85,2006-03-24,Stay Alive,20000000,23086480,23187506,3187506,3,101026,2006,15.937529999999999
2585,86,2005-10-07,2 For the Money,20000000,22991379,30491379,10491379,10,7500000,2005,52.456895
2586,87,2017-06-16,Rough Night,20000000,22105643,46844357,26844357,6,24738714,2017,134.22178499999998
2587,88,1998-12-04,Psycho,20000000,21541218,37226218,17226218,12,15685000,1998,86.13109
2588,89,1990-10-19,Quigley Down Under,20000000,21413105,21413105,1413105,10,0,1990,7.065525
2589,90,1995-09-27,To Die For,20000000,21284514,27688744,7688744,9,6404230,1995,38.44372
2590,91,2009-08-21,Shorts,20000000,20919166,29870801,9870801,8,8951635,2009,49.354005
2591,92,1998-10-30,Vampires,20000000,20268825,20268825,268825,10,0,1998,1.344125
2592,93,2008-09-19,Appaloosa,20000000,20211394,27911453,7911453,9,7700059,2008,39.557265
2593,94,2015-11-20,Secret in Their Eyes,20000000,20180155,32608019,12608019,11,12427864,2015,63.040094999999994
2594,95,2004-08-13,Yu-Gi-Oh,20000000,19762690,28762690,8762690,8,9000000,2004,43.813449999999996
2595,96,2007-03-23,Reign Over Me,20000000,19661987,20081987,81987,3,420000,2007,0.409935
2596,97,2008-09-19,My Best Friend's Girl,20000000,19219250,34787111,14787111,9,15567861,2008,73.935555
2597,98,2007-05-11,Georgia Rule,20000000,18882880,20819601,819601,5,1936721,2007,4.098005
2598,99,1981-07-31,Under the Rainbow,20000000,18826490,18826490,-1173510,7,0,1981,-5.86755
2599,100,1985-04-12,Ladyhawke,20000000,18400000,18400000,-1600000,4,0,1985,-8.0
2600,1,2007-09-21,Into the Wild,20000000,18354356,56822960,36822960,9,38468604,2007,184.1148
2601,2,1998-09-11,Simon Birch,20000000,18253415,18310591,-1689409,9,57176,1998,-8.447045000000001
2602,3,2005-02-11,Pooh's Heffalump Movie,20000000,18098433,55686944,35686944,2,37588511,2005,178.43472
2603,4,2006-09-29,School for Scoundrels,20000000,17807569,17807569,-2192431,9,0,2006,-10.962155
2604,5,2012-10-26,Silent Hill: Revelation 3D,20000000,17530219,55975672,35975672,10,38445453,2012,179.87836
2605,6,1995-11-03,Home for the Holidays,20000000,17468887,22119269,2119269,11,4650382,1995,10.596345
2606,7,2017-03-31,The Zookeeperâs Wife,20000000,17445186,26308749,6308749,3,8863563,2017,31.543745
2607,8,2009-02-20,Fired Up,20000000,17231291,18608570,-1391430,2,1377279,2009,-6.9571499999999995
2608,9,2005-04-08,Kung Fu Hustle,20000000,17104669,102034104,82034104,4,84929435,2005,410.17051999999995
2609,10,2002-07-26,The Country Bears,20000000,16988996,16988996,-3011004,7,0,2002,-15.055019999999999
2610,11,2017-09-29,Flatliners,20000000,16883115,45173738,25173738,9,28290623,2017,125.86869
2611,12,2007-03-16,Dead Silence,20000000,16574590,20614661,614661,3,4040071,2007,3.073305
2612,13,2003-11-21,21 Grams,20000000,16248701,59667625,39667625,11,43418924,2003,198.33812500000002
2613,14,2009-12-04,Armored,20000000,15988876,23661038,3661038,12,7672162,2009,18.30519
2614,15,2007-12-14,The Kite Runner,20000000,15800078,74180745,54180745,12,58380667,2007,270.903725
2615,16,2004-09-03,Paparazzi,20000000,15712072,16612072,-3387928,9,900000,2004,-16.93964
2616,17,2003-01-17,A Guy Thing,20000000,15543862,17430594,-2569406,1,1886732,2003,-12.84703
2617,18,1965-02-15,The Greatest Story Ever Told,20000000,15473333,15473333,-4526667,2,0,1965,-22.633335
2618,19,2000-07-21,Loser,20000000,15464026,18250106,-1749894,7,2786080,2000,-8.749469999999999
2619,20,1998-03-06,Twilight,20000000,15055091,15055091,-4944909,3,0,1998,-24.724545
2620,21,2009-09-23,Capitalism: A Love Story,20000000,14363397,19121531,-878469,9,4758134,2009,-4.392345000000001
2621,22,2012-04-13,Lockout,20000000,14326865,33943049,13943049,4,19616184,2012,69.71524500000001
2622,23,2008-08-29,Disaster Movie,20000000,14190901,36720752,16720752,8,22529851,2008,83.60376000000001
2623,24,2011-09-30,What's Your Number?,20000000,14011084,30163785,10163785,9,16152701,2011,50.81892500000001
2624,25,1997-11-14,The Man Who Knew Too Little,20000000,13801755,13801755,-6198245,11,0,1997,-30.991225
2625,26,2009-04-17,Crank 2: High Voltage,20000000,13684249,35472739,15472739,4,21788490,2009,77.36369499999999
2626,27,2015-10-30,Burnt,20000000,13651946,36773510,16773510,10,23121564,2015,83.86755000000001
2627,28,2004-04-30,Envy,20000000,13548322,14566246,-5433754,4,1017924,2004,-27.16877
2628,29,2006-10-13,One Night with the King,20000000,13395961,13725032,-6274968,10,329071,2006,-31.37484
2629,30,1994-10-21,Bullets Over Broadway,20000000,13383747,13383747,-6616253,10,0,1994,-33.081265
2630,31,2008-09-19,Ghost Town,20000000,13367624,29958228,9958228,9,16590604,2008,49.79114
2631,32,2002-11-22,The Quiet American,20000000,12987647,26348203,6348203,11,13360556,2002,31.741015
2632,33,2016-02-26,Triple 9,20000000,12639297,25943792,5943792,2,13304495,2016,29.71896
2633,34,2016-09-02,The Light Between Oceans,20000000,12545979,22281732,2281732,9,9735753,2016,11.40866
2634,35,2005-10-28,The Weather Man,20000000,12482775,15466961,-4533039,10,2984186,2005,-22.665195
2635,36,2002-08-23,Undisputed,20000000,12398628,12398628,-7601372,8,0,2002,-38.006859999999996
2636,37,2009-03-27,12 Rounds,20000000,12234694,17306648,-2693352,3,5071954,2009,-13.46676
2637,38,2010-10-01,Let Me In,20000000,12134935,28270399,8270399,10,16135464,2010,41.351995
2638,39,1994-05-06,3 Ninjas Kick Back,20000000,11744960,11744960,-8255040,5,0,1994,-41.2752
2639,40,2008-02-22,Be Kind Rewind,20000000,11175164,30894247,10894247,2,19719083,2008,54.47123499999999
2640,41,2005-12-09,Mrs. Henderson Presents,20000000,11036366,27836366,7836366,12,16800000,2005,39.18183
2641,42,1997-12-12,Deconstructing Harry,20000000,10686841,10686841,-9313159,12,0,1997,-46.565795
2642,43,1999-10-22,Three to Tango,20000000,10570375,10570375,-9429625,10,0,1999,-47.148125
2643,44,1989-12-15,We're No Angels,20000000,10555348,10555348,-9444652,12,0,1989,-47.22326
2644,45,1996-12-06,Everyone Says I Love You,20000000,9725847,34600000,14600000,12,24874153,1996,73.0
2645,46,2007-08-31,Death Sentence,20000000,9534258,16907831,-3092169,8,7373573,2007,-15.460845
2646,47,2016-06-03,Popstar: Never Stop Never Stopping,20000000,9496130,9537120,-10462880,6,40990,2016,-52.314400000000006
2647,48,2017-10-27,Thank You for Your Service,20000000,9479390,9985316,-10014684,10,505926,2017,-50.07342
2648,49,2009-12-04,Everybody's Fine,20000000,9208876,9208876,-10791124,12,0,2009,-53.95562
2649,50,2004-08-27,Superbabies: Baby Geniuses 2,20000000,9109322,9355369,-10644631,8,246047,2004,-53.223155
2650,51,2013-09-20,Battle of the Year,20000000,8888355,16723377,-3276623,9,7835022,2013,-16.383115
2651,52,2016-04-29,Ratchet and Clank,20000000,8813410,14365639,-5634361,4,5552229,2016,-28.171805
2652,53,2007-08-17,Death at a Funeral,20000000,8580428,46790428,26790428,8,38210000,2007,133.95213999999999
2653,54,2005-09-09,The Man,20000000,8330720,10393696,-9606304,9,2062976,2005,-48.03152
2654,55,2007-01-05,Code Name: The Cleaner,20000000,8135024,8135024,-11864976,1,0,2007,-59.32488
2655,56,2014-12-12,Inherent Vice,20000000,8110975,14772346,-5227654,12,6661371,2014,-26.138270000000002
2656,57,2004-04-16,Connie & Carla,20000000,8047525,8047525,-11952475,4,0,2004,-59.762375
2657,58,2013-10-11,Machete Kills,20000000,8008161,18273009,-1726991,10,10264848,2013,-8.634955
2658,59,1969-01-01,Sweet Charity,20000000,8000000,8000000,-12000000,1,0,1969,-60.0
2659,60,2006-02-24,Doogal,20000000,7578946,28058652,8058652,2,20479706,2006,40.29326
2660,61,2005-09-16,Proof,20000000,7535331,8284331,-11715669,9,749000,2005,-58.578345
2661,62,2008-10-03,An American Carol,20000000,7013191,7022183,-12977817,10,8992,2008,-64.88908500000001
2662,63,2003-03-14,Willard,20000000,6882696,6882696,-13117304,3,0,2003,-65.58652000000001
2663,64,2008-02-01,Strange Wilderness,20000000,6575282,6947084,-13052916,2,371802,2008,-65.26458000000001
2664,65,2015-04-24,Little Boy,20000000,6485961,17769299,-2230701,4,11283338,2015,-11.153505
2665,66,1999-12-17,Topsy Turvy,20000000,6201757,6201757,-13798243,12,0,1999,-68.991215
2666,67,2012-10-26,Chasing Mavericks,20000000,6002756,8300821,-11699179,10,2298065,2012,-58.495895
2667,68,2014-12-31,A Most Violent Year,20000000,5749134,8846875,-11153125,12,3097741,2014,-55.765625
2668,69,2011-11-23,A Dangerous Method,20000000,5702083,14807531,-5192469,11,9105448,2011,-25.962345
2669,70,2006-07-07,A Scanner Darkly,20000000,5501616,7405084,-12594916,7,1903468,2006,-62.97458
2670,71,2009-08-14,Bandslam,20000000,5210988,12967829,-7032171,8,7756841,2009,-35.160855000000005
2671,72,2005-01-28,Alone in the Dark,20000000,5178569,10588079,-9411921,1,5409510,2005,-47.059605
2672,73,2004-10-29,Birth,20000000,5005899,14603001,-5396999,10,9597102,2004,-26.984995
2673,74,2016-08-26,Hands of Stone,20000000,4712792,5031975,-14968025,8,319183,2016,-74.840125
2674,75,2008-10-24,Passchendaele,20000000,4452423,4453327,-15546673,10,904,2008,-77.73336499999999
2675,76,2008-10-03,Flash of Genius,20000000,4442377,4504111,-15495889,10,61734,2008,-77.479445
2676,77,2007-11-21,Iâm Not There,20000000,4017609,12397613,-7602387,11,8380004,2007,-38.011935
2677,78,2012-09-07,The Cold Light of Day,20000000,3763583,25361206,5361206,9,21597623,2012,26.806029999999996
2678,79,2009-05-15,The Brothers Bloom,20000000,3531756,5531756,-14468244,5,2000000,2009,-72.34121999999999
2679,80,2008-10-24,"Synecdoche, New York",20000000,3083538,4383538,-15616462,10,1300000,2008,-78.08230999999999
2680,81,2018-10-26,Suspiria,20000000,2483472,7034615,-12965385,10,4551143,2018,-64.826925
2681,82,2017-11-03,LBJ,20000000,2468683,2507181,-17492819,11,38498,2017,-87.464095
2682,83,1999-10-29,Mononoke-hime,20000000,2374107,150350000,130350000,10,147975893,1999,651.75
2683,84,2004-03-19,Bon Voyage,20000000,2353728,8361736,-11638264,3,6008008,2004,-58.191320000000005
2684,85,2015-11-13,My All-American,20000000,2246000,2246000,-17754000,11,0,2015,-88.77000000000001
2685,86,1980-06-20,Can't Stop the Music,20000000,2000000,2000000,-18000000,6,0,1980,-90.0
2686,87,2006-05-05,The Proposition,20000000,1903434,5313608,-14686392,5,3410174,2006,-73.43195999999999
2687,88,2003-08-22,Marci X,20000000,1646664,1646664,-18353336,8,0,2003,-91.76668
2688,89,2002-12-06,Equilibrium,20000000,1190018,5345869,-14654131,12,4155851,2002,-73.27065499999999
2689,90,2011-04-29,Dylan Dog: Dead of Night,20000000,1186538,6093725,-13906275,4,4907187,2011,-69.531375
2690,91,2012-08-29,The Oogieloves in the BIG Balloon Adventure,20000000,1065907,1065907,-18934093,8,0,2012,-94.67046500000001
2691,92,2008-05-23,The Children of Huang Shi,20000000,1031872,8221700,-11778300,5,7189828,2008,-58.89149999999999
2692,93,2000-10-20,The Yards,20000000,882710,2282710,-17717290,10,1400000,2000,-88.58645
2693,94,2010-08-06,Middle Men,20000000,754301,754301,-19245699,8,0,2010,-96.22849500000001
2694,95,2017-04-28,JÃ¬yÃ¬ dÃ shÄ«,20000000,587470,43888531,23888531,4,43301061,2017,119.442655
2695,96,2010-12-03,All Good Things,20000000,582024,873617,-19126383,12,291593,2010,-95.631915
2696,97,2015-11-13,By the Sea,20000000,538460,3727746,-16272254,11,3189286,2015,-81.36126999999999
2697,98,2005-03-18,Steamboy,20000000,468867,10468867,-9531133,3,10000000,2005,-47.655665
2698,99,2005-04-22,The Game of Their Lives,20000000,375474,375474,-19624526,4,0,2005,-98.12263
2699,100,1994-09-11,Rapa Nui,20000000,305070,305070,-19694930,9,0,1994,-98.47465
2700,1,2010-12-10,The Tempest,20000000,277943,277943,-19722057,12,0,2010,-98.610285
2701,2,2008-03-07,é·æ±ä¸è (CJ7),20000000,206678,47300771,27300771,3,47094093,2008,136.503855
2702,3,2009-09-18,The Burning Plain,20000000,200730,1167092,-18832908,9,966362,2009,-94.16454
2703,4,1998-03-27,Les Couloirs du temps: Les visiteurs 2,20000000,146072,26146072,6146072,3,26000000,1998,30.73036
2704,5,2003-04-25,People I Know,20000000,121972,5694213,-14305787,4,5572241,2003,-71.528935
2705,6,2015-10-30,Regression,20000000,55039,15824374,-4175626,10,15769335,2015,-20.87813
2706,7,2008-12-31,Admiral,20000000,0,38585047,18585047,12,38585047,2008,92.925235
2707,8,2012-12-31,Zambezia,20000000,0,34454336,14454336,12,34454336,2012,72.27168
2708,9,2010-04-13,Three Kingdoms: Resurrection of the Dragon,20000000,0,22139590,2139590,4,22139590,2010,10.69795
2709,10,2004-03-31,The Touch,20000000,0,5918742,-14081258,3,5918742,2004,-70.40629
2710,11,2015-05-29,Survivor,20000000,0,1703281,-18296719,5,1703281,2015,-91.483595
2711,12,2016-11-18,The History of Love,20000000,0,476624,-19523376,11,476624,2016,-97.61688
2712,13,2007-12-25,Butterfly on a Wheel,20000000,0,0,-20000000,12,0,2007,-100.0
2713,14,2014-08-29,Dwegons and Leprechauns,20000000,0,0,-20000000,8,0,2014,-100.0
2714,15,2016-07-22,Fight Valley,20000000,0,0,-20000000,7,0,2016,-100.0
2715,16,2017-12-31,The Thousand Miles,20000000,0,0,-20000000,12,0,2017,-100.0
2716,17,2018-12-13,Bird Box,19800000,0,0,-19800000,12,0,2018,-100.0
2717,18,2009-08-21,Der Baader Meinhof Komplex,19700000,476270,16498827,-3201173,8,16022557,2009,-16.249609137055838
2718,19,2017-12-01,The Shape of Water,19500000,63859435,195790794,176290794,12,131931359,2017,904.0553538461538
2719,20,2012-11-23,De rouille et dâos,19500000,2061449,29393634,9893634,11,27332185,2012,50.736584615384615
2720,21,2006-12-20,The Painted Veil,19400000,8060487,15118795,-4281205,12,7058308,2006,-22.068067010309278
2721,22,2013-08-23,The Frozen Ground,19200000,0,5617460,-13582540,8,5617460,2013,-70.74239583333333
2722,23,2011-07-29,The Devil's Double,19100000,1361512,5965646,-13134354,7,4604134,2011,-68.76625130890052
2723,24,1985-07-03,Back to the Future,19000000,212259762,385524784,366524784,7,173265022,1985,1929.0778105263157
2724,25,1990-11-09,Dances with Wolves,19000000,184208842,424200000,405200000,11,239991158,1990,2132.631578947369
2725,26,2000-07-07,Scary Movie,19000000,157019771,277200000,258200000,7,120180229,2000,1358.9473684210527
2726,27,2011-06-24,Bad Teacher,19000000,100292856,215448997,196448997,6,115156141,2011,1033.942089473684
2727,28,2016-08-12,Sausage Party,19000000,97670358,141344255,122344255,8,43673897,2016,643.9171315789474
2728,29,1989-09-15,Sea of Love,19000000,58571513,58571513,39571513,9,0,1989,208.27112105263157
2729,30,2003-01-10,Just Married,19000000,56127162,101564935,82564935,1,45437773,2003,434.5522894736842
2730,31,2009-09-11,I Can Do Bad All By Myself,19000000,51733921,51733921,32733921,9,0,2009,172.2837947368421
2731,32,2004-07-16,A Cinderella Story,19000000,51438175,70164105,51164105,7,18725930,2004,269.28476315789476
2732,33,1980-05-23,The Shining,19000000,44017374,44728227,25728227,5,710853,1980,135.41172105263158
2733,34,2001-10-26,Thirteen Ghosts,19000000,41867960,68467960,49467960,10,26600000,2001,260.3576842105263
2734,35,1999-10-29,House on Haunted Hill,19000000,40846082,65090541,46090541,10,24244459,1999,242.58179473684208
2735,36,2010-02-26,The Crazies,19000000,39123589,56445534,37445534,2,17321945,2010,197.08175789473685
2736,37,2009-01-16,Notorious,19000000,36843682,44972183,25972183,1,8128501,2009,136.6957
2737,38,2018-11-02,Nobodyâs Fool,19000000,31713110,32589493,13589493,11,876383,2018,71.52364736842105
2738,39,2010-08-20,The Switch,19000000,27758465,49858465,30858465,8,22100000,2010,162.41297368421053
2739,40,2010-01-08,Leap Year,19000000,25918920,32618920,13618920,1,6700000,2010,71.67852631578947
2740,41,2013-11-08,The Book Thief,19000000,21488481,76086711,57086711,11,54598230,2013,300.4563736842105
2741,42,2007-10-19,"Gone, Baby, Gone",19000000,20300218,34352162,15352162,10,14051944,2007,80.80085263157895
2742,43,2000-07-26,Thomas and the Magic Railroad,19000000,15911332,15911332,-3088668,7,0,2000,-16.256147368421054
2743,44,1962-11-08,Mutiny on The Bounty,19000000,13680000,13680000,-5320000,11,0,1962,-28.000000000000004
2744,45,2002-09-20,Sen to Chihiro no Kamikakushi,19000000,10049886,274949886,255949886,9,264900000,2002,1347.1046631578947
2745,46,2008-10-17,Sex Drive,19000000,8402485,10412485,-8587515,10,2010000,2008,-45.19744736842105
2746,47,1998-01-09,Firestorm,19000000,8123860,8123860,-10876140,1,0,1998,-57.24284210526316
2747,48,2011-03-04,Take Me Home Tonight,19000000,6928068,7576604,-11423396,3,648536,2011,-60.12313684210526
2748,49,2012-09-28,Won't Back Down,19000000,5310554,5745503,-13254497,9,434949,2012,-69.76051052631578
2749,50,2018-06-01,Action Point,19000000,5059608,5103675,-13896325,6,44067,2018,-73.13855263157895
2750,51,1964-01-01,The Fall of the Roman Empire,19000000,4750000,4750000,-14250000,1,0,1964,-75.0
2751,52,1993-11-24,The Nutcracker,19000000,2119994,2119994,-16880006,11,0,1993,-88.84213684210526
2752,53,2011-12-13,George Balanchine\'s The Nutcracker,19000000,2119994,2119994,-16880006,12,0,2011,-88.84213684210526
2753,54,1996-08-16,Kansas City,19000000,1353824,1353824,-17646176,8,0,1996,-92.87461052631579
2754,55,2016-03-08,Out of the Inferno,19000000,0,0,-19000000,3,0,2016,-100.0
2755,56,2005-06-24,George A. Romero's Land of the Dead,18975000,20700082,47751015,28776015,6,27050933,2005,151.65225296442688
2756,57,2006-12-15,IndigÃ¨nes,18900000,320700,26063572,7163572,12,25742872,2006,37.902497354497356
2757,58,2005-04-15,The Amityville Horror,18500000,65233369,109175673,90675673,4,43942304,2005,490.13877297297296
2758,59,2002-12-06,Adaptation,18500000,22498520,32531759,14031759,12,10033239,2002,75.84734594594595
2759,60,2009-10-02,The Invention of Lying,18500000,18451251,32679264,14179264,10,14228013,2009,76.64467027027027
2760,61,1998-05-22,Fear and Loathing in Las Vegas,18500000,10680275,13711903,-4788097,5,3031628,1998,-25.881605405405406
2761,62,2008-07-04,Ne le dis Ã personne,18500000,6198883,33954018,15454018,7,27755135,2008,83.53523243243242
2762,63,2001-02-02,Left Behind,18500000,4221341,4221341,-14278659,2,0,2001,-77.18194054054054
2763,64,2014-05-09,Neighbors,18000000,150086800,270944428,252944428,5,120857628,2014,1405.2468222222221
2764,65,2006-11-03,Borat,18000000,128505958,261443242,243443242,11,132937284,2006,1352.4624555555556
2765,66,1994-07-29,The Mask,18000000,119920129,351620129,333620129,7,231700000,1994,1853.4451611111112
2766,67,1988-06-03,Big,18000000,114968774,151668774,133668774,6,36700000,1988,742.6043
2767,68,2001-07-13,Legally Blonde,18000000,96493426,141809235,123809235,7,45315809,2001,687.8290833333334
2768,69,2004-04-30,Mean Girls,18000000,86047227,130953026,112953026,4,44905799,2004,627.5168111111111
2769,70,1984-06-01,Star Trek III: The Search for Spock,18000000,76471046,87000000,69000000,6,10528954,1984,383.33333333333337
2770,71,2005-09-09,The Exorcism of Emily Rose,18000000,75072454,144529078,126529078,9,69456624,2005,702.9393222222222
2771,72,1999-12-10,Deuce Bigalow: Male Gigolo,18000000,65535067,92935067,74935067,12,27400000,1999,416.3059277777778
2772,73,2004-01-01,Barbershop 2: Back in Business,18000000,65070412,65842412,47842412,1,772000,2004,265.79117777777776
2773,74,2005-12-16,The Family Stone,18000000,60062868,92357499,74357499,12,32294631,2005,413.0972166666667
2774,75,2003-11-26,Bad Santa,18000000,60060328,77147031,59147031,11,17086703,2003,328.5946166666667
2775,76,1987-06-12,Predator,18000000,59735548,98267558,80267558,6,38532010,1987,445.9308777777777
2776,77,2016-03-25,My Big Fat Greek Wedding 2,18000000,59689605,92096558,74096558,3,32406953,2016,411.6475444444444
2777,78,2015-09-11,The Perfect Guy,18000000,57027435,60278166,42278166,9,3250731,2015,234.8787
2778,79,1997-05-02,Austin Powers: International Man of Mystery,18000000,53883989,67683989,49683989,5,13800000,1997,276.02216111111113
2779,80,2011-03-25,Diary of a Wimpy Kid: Rodrick Rules,18000000,52698535,73695194,55695194,3,20996659,2011,309.41774444444445
2780,81,1984-09-19,Amadeus,18000000,51973029,51973029,33973029,9,0,1984,188.73905
2781,82,2008-04-11,Prom Night,18000000,43869350,57193655,39193655,4,13324305,2008,217.74252777777775
2782,83,2011-04-08,Soul Surfer,18000000,43853424,47158652,29158652,4,3305228,2011,161.9925111111111
2783,84,2003-09-26,Under the Tuscan Sun,18000000,43601508,57490024,39490024,9,13888516,2003,219.3890222222222
2784,85,2018-06-29,Uncle Drew,18000000,42469946,46527161,28527161,6,4057215,2018,158.4842277777778
2785,86,2014-10-17,Birdman or (The Unexpected Virtue of Ignorance),18000000,42340598,103215094,85215094,10,60874496,2014,473.41718888888886
2786,87,1986-10-10,Peggy Sue Got Married,18000000,41382841,41382841,23382841,10,0,1986,129.90467222222222
2787,88,2001-12-26,Gosford Park,18000000,41300105,41300105,23300105,12,0,2001,129.44502777777777
2788,89,2002-01-11,Orange County,18000000,41059716,43308707,25308707,1,2248991,2002,140.60392777777778
2789,90,2013-07-26,Blue Jasmine,18000000,33404871,102912961,84912961,7,69508090,2013,471.7386722222222
2790,91,2006-04-28,United 93,18000000,31567134,77635035,59635035,4,46067901,2006,331.30575000000005
2791,92,2003-12-05,Honey,18000000,30272254,62646763,44646763,12,32374509,2003,248.0375722222222
2792,93,2005-10-14,The Fog,18000000,29511112,37048526,19048526,10,7537414,2005,105.82514444444445
2793,94,1996-05-24,Spy Hard,18000000,26936265,26936265,8936265,5,0,1996,49.645916666666665
2794,95,2015-08-07,Ricki and the Flash,18000000,26839498,41166033,23166033,8,14326535,2015,128.70018333333334
2795,96,1989-12-13,Glory,18000000,26593580,26593580,8593580,12,0,1989,47.742111111111114
2796,97,1984-06-29,Conan the Destroyer,18000000,26400000,26400000,8400000,6,0,1984,46.666666666666664
2797,98,2015-11-13,Love the Coopers,18000000,26302731,42227490,24227490,11,15924759,2015,134.59716666666665
2798,99,1970-06-24,Catch-22,18000000,24911670,24911670,6911670,6,0,1970,38.39816666666667
2799,100,2009-04-10,Observe and Report,18000000,24007324,27148898,9148898,4,3141574,2009,50.82721111111111
2800,1,1980-11-14,Raging Bull,18000000,23380203,23380203,5380203,11,0,1980,29.890016666666668
2801,2,2009-09-18,Love Happens,18000000,22965110,36133014,18133014,9,13167904,2009,100.73896666666667
2802,3,2009-09-25,Fame,18000000,22455510,80227619,62227619,9,57772109,2009,345.70899444444444
2803,4,2017-04-28,The Circle,18000000,20497844,40651864,22651864,4,20154020,2017,125.84368888888888
2804,5,1985-12-04,Young Sherlock Holmes,18000000,19739000,19739000,1739000,12,0,1985,9.661111111111111
2805,6,2010-11-05,127 Hours,18000000,18335230,60217171,42217171,11,41881941,2010,234.5398388888889
2806,7,2000-05-19,Small Time Crooks,18000000,17266359,29934477,11934477,5,12668118,2000,66.30265
2807,8,2000-05-12,Center Stage,18000000,17200925,21361109,3361109,5,4160184,2000,18.67282777777778
2808,9,2016-01-15,Norm of the North,18000000,17062499,30535660,12535660,1,13473161,2016,69.64255555555555
2809,10,2004-02-06,Catch That Kid,18000000,16703799,16959614,-1040386,2,255815,2004,-5.779922222222222
2810,11,2013-08-16,Jobs,18000000,16131410,43402515,25402515,8,27271105,2013,141.12508333333332
2811,12,2001-10-26,Life as a House,18000000,15652637,23889158,5889158,10,8236521,2001,32.71754444444445
2812,13,2010-01-08,Youth in Revolt,18000000,15285588,19685588,1685588,1,4400000,2010,9.36437777777778
2813,14,2014-07-25,And So It Goes,18000000,15160801,17920013,-79987,7,2759212,2014,-0.4443722222222222
2814,15,2009-07-10,"I Love You, Beth Cooper",18000000,14800725,16382538,-1617462,7,1581813,2009,-8.985899999999999
2815,16,1981-07-24,Blow Out,18000000,13747234,13747234,-4252766,7,0,1981,-23.626477777777776
2816,17,2001-03-30,The Tailor of Panama,18000000,13491653,27491653,9491653,3,14000000,2001,52.731405555555554
2817,18,1981-05-22,The Legend of the Lone Ranger,18000000,13400000,13400000,-4600000,5,0,1981,-25.555555555555554
2818,19,2014-01-31,Labor Day,18000000,13371528,14189810,-3810190,1,818282,2014,-21.16772222222222
2819,20,2013-08-30,Getaway,18000000,10501938,11813989,-6186011,8,1312051,2013,-34.366727777777776
2820,21,1997-09-26,The Ice Storm,18000000,8038061,16011975,-1988025,9,7973914,1997,-11.044583333333332
2821,22,2004-10-15,Being Julia,18000000,7739049,14488705,-3511295,10,6749656,2004,-19.507194444444444
2822,23,1989-03-22,Troop Beverly Hills,18000000,7190505,7190505,-10809495,3,0,1989,-60.052749999999996
2823,24,1986-02-21,Nine 1/2 Weeks,18000000,6734844,6734844,-11265156,2,0,1986,-62.5842
2824,25,2010-01-15,The Last Station,18000000,6617867,15696146,-2303854,1,9078279,2010,-12.799188888888887
2825,26,1981-06-26,Dragonslayer,18000000,6000000,6000000,-12000000,6,0,1981,-66.66666666666666
2826,27,1994-09-30,Ed Wood,18000000,5828466,5828466,-12171534,9,0,1994,-67.61963333333333
2827,28,2008-06-06,Mongol,18000000,5705761,27147349,9147349,6,21441588,2008,50.81860555555555
2828,29,2008-10-08,RocknRolla,18000000,5700626,27794339,9794339,10,22093713,2008,54.41299444444444
2829,30,1982-06-25,Megaforce,18000000,5675599,5675599,-12324401,6,0,1982,-68.46889444444444
2830,31,2010-08-20,Mao's Last Dancer,18000000,4806750,25941437,7941437,8,21134687,2010,44.11909444444444
2831,32,1996-12-25,Hamlet,18000000,4501094,7129670,-10870330,12,2628576,1996,-60.39072222222222
2832,33,2014-04-11,The Railway Man,18000000,4438438,23910210,5910210,4,19471772,2014,32.8345
2833,34,1995-12-29,Restoration,18000000,4100000,4100000,-13900000,12,0,1995,-77.22222222222223
2834,35,2016-03-18,Midnight Special,18000000,3712282,7680250,-10319750,3,3967968,2016,-57.331944444444446
2835,36,2016-11-25,Miss Sloane,18000000,3500605,7719630,-10280370,11,4219025,2016,-57.11316666666667
2836,37,2013-09-27,Metallica Through the Never,18000000,3419967,9082906,-8917094,9,5662939,2013,-49.53941111111111
2837,38,2003-09-19,Anything Else,18000000,3203044,13203044,-4796956,9,10000000,2003,-26.649755555555554
2838,39,1996-02-23,Unforgettable,18000000,2483790,2483790,-15516210,2,0,1996,-86.20116666666667
2839,40,2017-03-17,T2: Trainspotting,18000000,2402004,42091262,24091262,3,39689258,2017,133.84034444444444
2840,41,2009-12-30,Das Weisse Band: Eine deutsche Kindergeschichte,18000000,2222862,25727044,7727044,12,23504182,2009,42.928022222222225
2841,42,1986-04-25,8 Million Ways to Die,18000000,1305114,1305114,-16694886,4,0,1986,-92.74936666666666
2842,43,2013-03-01,Phantom,18000000,1034589,1199510,-16800490,3,164921,2013,-93.33605555555555
2843,44,2002-04-26,The Salton Sea,18000000,676698,676698,-17323302,4,0,2002,-96.24056666666667
2844,45,2009-04-24,The Informers,18000000,315000,315000,-17685000,4,0,2009,-98.25
2845,46,1999-09-24,One Man's Hero,18000000,229311,229311,-17770689,9,0,1999,-98.72605
2846,47,2010-10-15,Carlos,18000000,145526,1619153,-16380847,10,1473627,2010,-91.00470555555556
2847,48,2006-09-22,Renaissance,18000000,70644,2401413,-15598587,9,2330769,2006,-86.65881666666667
2848,49,2008-12-31,I Come with the Rain,18000000,0,627422,-17372578,12,627422,2008,-96.51432222222223
2849,50,2016-04-15,I Am Wrath,18000000,0,309608,-17690392,4,309608,2016,-98.27995555555556
2850,51,2014-11-14,Wolves,18000000,0,94953,-17905047,11,94953,2014,-99.47248333333333
2851,52,2008-04-08,Day of the Dead,18000000,0,0,-18000000,4,0,2008,-100.0
2852,53,2014-08-22,The Prince,18000000,0,0,-18000000,8,0,2014,-100.0
2853,54,2016-02-19,Forsaken,18000000,0,0,-18000000,2,0,2016,-100.0
2854,55,1985-06-28,Red Sonja,17900000,6905861,6908640,-10991360,6,2779,1985,-61.40424581005587
2855,56,2012-07-13,Red Lights,17700000,49521,14518884,-3181116,7,14469363,2012,-17.972406779661018
2856,57,2007-08-17,Superbad,17500000,121463226,169955142,152455142,8,48491916,2007,871.1722399999999
2857,58,2009-02-20,Madea Goes To Jail,17500000,90508336,90508336,73008336,2,0,2009,417.1904914285714
2858,59,2008-02-14,Step Up 2 the Streets,17500000,58017783,148586910,131086910,2,90569127,2008,749.0680571428571
2859,60,2006-01-13,Hoodwinked,17500000,51386611,109843390,92343390,1,58456779,2006,527.6765142857143
2860,61,2004-12-22,Hotel Rwanda,17500000,23519128,36521223,19021223,12,13002095,2004,108.69270285714285
2861,62,2006-08-25,Beerfest,17500000,19185184,20159316,2659316,8,974132,2006,15.196091428571428
2862,63,2013-11-27,Black Nativity,17500000,7018188,7285135,-10214865,11,266947,2013,-58.37065714285714
2863,64,2003-04-25,City of Ghosts,17500000,325491,325491,-17174509,4,0,2003,-98.14005142857143
2864,65,2007-12-31,Taxi 4,17500000,0,60865364,43365364,12,60865364,2007,247.80208
2865,66,2018-04-06,A Quiet Place,17000000,188024361,334522294,317522294,4,146497933,2018,1867.7782
2866,67,2001-08-10,The Others,17000000,96522687,207765056,190765056,8,111242369,2001,1122.147388235294
2867,68,1986-07-18,Aliens,17000000,85160248,183316455,166316455,7,98156207,1986,978.3320882352941
2868,69,2014-08-13,Letâs Be Cops,17000000,82390774,136890774,119890774,8,54500000,2014,705.2398470588236
2869,70,1997-10-17,I Know What You Did Last Summer,17000000,72250091,125250091,108250091,10,53000000,1997,636.7652411764706
2870,71,1964-10-22,My Fair Lady,17000000,72000000,72071636,55071636,10,71636,1964,323.95079999999996
2871,72,2004-10-22,Sideways,17000000,71502303,109793192,92793192,10,38290889,2004,545.842305882353
2872,73,2013-11-15,The Best Man Holiday,17000000,70525195,72835710,55835710,11,2310515,2013,328.44535294117645
2873,74,2009-02-13,Friday the 13th,17000000,65002019,92670237,75670237,2,27668218,2009,445.11904117647066
2874,75,2012-09-28,Pitch Perfect,17000000,65001093,116044347,99044347,9,51043254,2012,582.613805882353
2875,76,1998-08-05,Halloween: H2O,17000000,55041738,55041738,38041738,8,0,1998,223.7749294117647
2876,77,2013-04-05,Evil Dead,17000000,54239856,97778356,80778356,4,43538500,2013,475.16679999999997
2877,78,2004-08-27,Jet Li's Hero,17000000,53652140,177535958,160535958,8,123883818,2004,944.3291647058822
2878,79,2010-10-29,Saw 3D,17000000,45710178,133735284,116735284,10,88025106,2010,686.6781411764705
2879,80,2015-02-20,"McFarland, USA",17000000,44480275,45707924,28707924,2,1227649,2015,168.87014117647058
2880,81,2016-11-11,Almost Christmas,17000000,42065185,42493506,25493506,11,428321,2016,149.96179999999998
2881,82,2006-03-10,The Hills Have Eyes,17000000,41778863,70355813,53355813,3,28576950,2006,313.85772352941177
2882,83,2002-03-01,40 Days and 40 Nights,17000000,37939782,95092667,78092667,3,57152885,2002,459.3686294117647
2883,84,2003-10-10,Good Boy!,17000000,37667746,45312217,28312217,10,7644471,2003,166.54245294117646
2884,85,2007-01-26,Smokin' Aces,17000000,35662731,57263440,40263440,1,21600709,2007,236.84376470588236
2885,86,1998-10-02,A Night at the Roxbury,17000000,30331165,30331165,13331165,10,0,1998,78.41861764705882
2886,87,2011-03-04,Beastly,17000000,27865571,38028230,21028230,3,10162659,2011,123.6954705882353
2887,88,2010-03-05,Brooklyn's Finest,17000000,27163593,39233233,22233233,3,12069640,2010,130.78372352941176
2888,89,1982-07-09,Tron,17000000,26918576,26918576,9918576,7,0,1982,58.34456470588235
2889,90,2010-08-20,Lottery Ticket,17000000,24719879,24719879,7719879,8,0,2010,45.41105294117647
2890,91,2003-09-05,Dickie Roberts: Former Child Star,17000000,22734486,23734486,6734486,9,1000000,2003,39.614623529411766
2891,92,2006-03-31,ATL,17000000,21170563,21170563,4170563,3,0,2006,24.532723529411765
2892,93,2001-08-24,Summer Catch,17000000,19693891,19693891,2693891,8,0,2001,15.846417647058825
2893,94,1998-12-11,A Simple Plan,17000000,16316273,16316273,-683727,12,0,1998,-4.021923529411764
2894,95,2006-03-24,Larry the Cable Guy: Health Inspector,17000000,15680099,15680099,-1319901,3,0,2006,-7.764123529411765
2895,96,2002-11-27,Wes Craven Presents: They,17000000,12840842,16140842,-859158,11,3300000,2002,-5.053870588235294
2896,97,1999-10-01,The Adventures of Elmo in Grouchland,17000000,11634458,11634458,-5365542,10,0,1999,-31.562011764705883
2897,98,1987-07-24,Superman IV: The Quest for Peace,17000000,11227824,11227824,-5772176,7,0,1987,-33.95397647058824
2898,99,1963-05-29,55 Days at Peking,17000000,10000000,10000000,-7000000,5,0,1963,-41.17647058823529
2899,100,2009-06-05,My Life in Ruins,17000000,8677425,20477425,3477425,6,11800000,2009,20.455441176470586
2900,1,2006-04-21,American Dreamz,17000000,7314027,16510971,-489029,4,9196944,2006,-2.876641176470588
2901,2,2008-01-25,How She Move,17000000,7070641,8607815,-8392185,1,1537174,2008,-49.36579411764706
2902,3,2006-02-24,Running Scared,17000000,6855137,9729088,-7270912,2,2873951,2006,-42.77007058823529
2903,4,2012-08-24,The Apparition,17000000,4936819,10637281,-6362719,8,5700462,2012,-37.42775882352941
2904,5,2004-04-30,Bobby Jones: Stroke of Genius,17000000,2694071,2694071,-14305929,4,0,2004,-84.15252352941177
2905,6,1986-08-29,Shanghai Surprise,17000000,2315000,2315000,-14685000,8,0,1986,-86.38235294117646
2906,7,2010-12-25,L'illusionniste,17000000,2231474,8609949,-8390051,12,6378475,2010,-49.35324117647058
2907,8,1981-01-01,Roar,17000000,2110050,2110050,-14889950,1,0,1981,-87.58794117647058
2908,9,2003-10-17,Veronica Guerin,17000000,1569918,9438074,-7561926,10,7868156,2003,-44.48191764705882
2909,10,2016-06-10,Genius,17000000,1361045,7265283,-9734717,6,5904238,2016,-57.26304117647059
2910,11,2007-11-14,Southland Tales,17000000,275380,364607,-16635393,11,89227,2007,-97.85525294117647
2911,12,2015-06-26,Escobar: Paradise Lost,17000000,195792,3917679,-13082321,6,3721887,2015,-76.9548294117647
2912,13,2017-09-26,"Mune, le gardien de la lune",17000000,0,14534046,-2465954,9,14534046,2017,-14.505611764705883
2913,14,2009-06-23,Chasseurs de dragons,17000000,0,13446115,-3553885,6,13446115,2009,-20.90520588235294
2914,15,1977-10-21,Damnation Alley,17000000,0,0,-17000000,10,0,1977,-100.0
2915,16,2019-07-12,Crawl,17000000,0,0,-17000000,7,0,2019,-100.0
2916,17,2016-03-11,The Young Messiah,16800000,6469813,7313697,-9486303,3,843884,2016,-56.46608928571428
2917,18,2006-11-10,FUR: An Imaginary Portrait of Diane Arbus,16800000,223202,2281089,-14518911,11,2057887,2006,-86.42208928571429
2918,19,1991-11-27,My Girl,16500000,58011485,58011485,41511485,11,0,1991,251.58475757575758
2919,20,1987-12-11,Wall Street,16500000,43848100,43848100,27348100,12,0,1987,165.7460606060606
2920,21,1995-12-11,Sense and Sensibility,16500000,42993774,134993774,118493774,12,92000000,1995,718.1440848484849
2921,22,2006-08-18,The Illusionist,16500000,39868642,83792062,67292062,8,43923420,2006,407.83067878787875
2922,23,2007-08-03,Becoming Jane,16500000,18663911,39380876,22880876,8,20716965,2007,138.67197575757575
2923,24,2003-12-19,House of Sand and Fog,16500000,13005485,16157923,-342077,12,3152438,2003,-2.0731939393939394
2924,25,2007-09-21,Sydney White,16500000,11892415,13636339,-2863661,9,1743924,2007,-17.35552121212121
2925,26,2007-12-31,Arn - Tempelriddaren,16500000,0,21404122,4904122,12,21404122,2007,29.721951515151517
2926,27,1989-06-02,Dead Poets Society,16400000,95860116,239500000,223100000,6,143639884,1989,1360.3658536585365
2927,28,1994-12-16,Dumb & Dumber,16000000,127175374,246400000,230400000,12,119224626,1994,1440.0
2928,29,1989-07-14,When Harry Met Sallyâ¦,16000000,92823546,92961960,76961960,7,138414,1989,481.01225000000005
2929,30,2000-05-19,Road Trip,16000000,68525609,119739110,103739110,5,51213501,2000,648.3694375
2930,31,1982-12-08,The Verdict,16000000,53977250,53977250,37977250,12,0,1982,237.3578125
2931,32,1999-01-15,Varsity Blues,16000000,52894169,54294169,38294169,1,1400000,1999,239.33855624999998
2932,33,2012-05-25,Moonrise Kingdom,16000000,45512466,68848446,52848446,5,23335980,2012,330.3027875
2933,34,2011-11-25,The Artist,16000000,44667095,128256712,112256712,11,83589617,2011,701.6044499999999
2934,35,2009-01-09,The Unborn,16000000,42670410,78208812,62208812,1,35538402,2009,388.805075
2935,36,2002-08-02,The Master of Disguise,16000000,40363530,40363530,24363530,8,0,2002,152.2720625
2936,37,2006-10-06,The Texas Chainsaw Massacre: The Beginning,16000000,39517763,50517763,34517763,10,11000000,2006,215.73601875000003
2937,38,2006-12-29,El Laberinto del Fauno,16000000,37634615,87041569,71041569,12,49406954,2006,444.00980625
2938,39,2011-02-04,The Roommate,16000000,37300107,52545707,36545707,2,15245600,2011,228.41066875
2939,40,2007-02-02,The Messengers,16000000,35374833,53774833,37774833,2,18400000,2007,236.09270625
2940,41,2001-03-02,See Spot Run,16000000,33357476,43057552,27057552,3,9700076,2001,169.1097
2941,42,1991-08-09,Double Impact,16000000,29090445,29090445,13090445,8,0,1991,81.81528125
2942,43,2001-06-27,Baby Boy,16000000,28734552,28734552,12734552,6,0,2001,79.59095
2943,44,2001-04-11,Joe Dirt,16000000,27087695,30987695,14987695,4,3900000,2001,93.67309375
2944,45,2008-09-12,The Women,16000000,26902075,50103808,34103808,9,23201733,2008,213.1488
2945,46,2007-04-20,Hot Fuzz,16000000,23618786,81742618,65742618,4,58123832,2007,410.89136249999996
2946,47,2008-08-15,Vicky Cristina Barcelona,16000000,23216709,104504817,88504817,8,81288108,2008,553.15510625
2947,48,2000-06-16,Boys and Girls,16000000,21799652,21799652,5799652,6,0,2000,36.247825
2948,49,2018-06-13,Superfly,16000000,20537137,20723581,4723581,6,186444,2018,29.522381250000002
2949,50,1994-11-18,LÃ©on,16000000,19284974,45284974,29284974,11,26000000,1994,183.03108749999998
2950,51,2010-03-12,Remember Me,16000000,19068240,56506120,40506120,3,37437880,2010,253.16325
2951,52,2002-10-11,White Oleander,16000000,16357770,21657770,5657770,10,5300000,2002,35.3610625
2952,53,2009-09-18,Jennifer's Body,16000000,16204793,31943401,15943401,9,15738608,2009,99.64625625
2953,54,2000-03-03,Drowning Mona,16000000,15427192,15980376,-19624,3,553184,2000,-0.12265
2954,55,1987-01-30,Radio Days,16000000,14792779,14792779,-1207221,1,0,1987,-7.545131250000001
2955,56,2003-07-18,How to Deal,16000000,14108518,14108518,-1891482,7,0,2003,-11.8217625
2956,57,2014-10-03,Left Behind,16000000,14019924,20769209,4769209,10,6749285,2014,29.80755625
2957,58,2004-05-28,Soul Plane,16000000,13922211,14553807,-1446193,5,631596,2004,-9.03870625
2958,59,1988-12-09,My Stepmother Is an Alien,16000000,13854000,13854000,-2146000,12,0,1988,-13.4125
2959,60,2012-06-29,People Like Us,16000000,12431792,12617472,-3382528,6,185680,2012,-21.140800000000002
2960,61,1999-05-28,The Thirteenth Floor,16000000,11810854,11810854,-4189146,5,0,1999,-26.1821625
2961,62,2004-09-03,The Cookout,16000000,11540112,11540112,-4459888,9,0,2004,-27.8743
2962,63,1979-10-19,Meteor,16000000,8400000,8400000,-7600000,10,0,1979,-47.5
2963,64,1986-03-07,Highlander,16000000,5900000,12900000,-3100000,3,7000000,1986,-19.375
2964,65,2016-11-18,Bleed for This,16000000,5083906,6603926,-9396074,11,1520020,2016,-58.725462500000006
2965,66,2002-05-03,Hollywood Ending,16000000,4839383,14839383,-1160617,5,10000000,2002,-7.25385625
2966,67,2000-09-15,Duets,16000000,4734235,6615452,-9384548,9,1881217,2000,-58.653425000000006
2967,68,1999-08-13,Detroit Rock City,16000000,4217115,5825314,-10174686,8,1608199,1999,-63.591787499999995
2968,69,2007-10-19,Things We Lost in the Fire,16000000,3287315,8120148,-7879852,10,4832833,2007,-49.249075
2969,70,2014-11-14,The Homesman,16000000,2429989,8217571,-7782429,11,5787582,2014,-48.64018125
2970,71,2013-04-05,Trance,16000000,2322593,22594052,6594052,4,20271459,2013,41.212824999999995
2971,72,2014-05-16,The Immigrant,16000000,2013456,7585011,-8414989,5,5571555,2014,-52.59368125
2972,73,1997-08-15,Steel,16000000,1686429,1686429,-14313571,8,0,1997,-89.45981875
2973,74,2005-12-21,The White Countess,16000000,1669971,2814566,-13185434,12,1144595,2005,-82.4089625
2974,75,2008-07-25,Bienvenue chez les Ch'tis,16000000,1477650,247474497,231474497,7,245996847,2008,1446.71560625
2975,76,2014-10-01,"Men, Women and Children",16000000,705908,1685403,-14314597,10,979495,2014,-89.46623124999999
2976,77,2010-09-24,Enter the Void,16000000,337997,1467278,-14532722,9,1129281,2010,-90.82951249999999
2977,78,2008-12-31,Good,16000000,31631,31631,-15968369,12,0,2008,-99.80230625
2978,79,2012-11-02,Vamps,16000000,3361,94812,-15905188,11,91451,2012,-99.407425
2979,80,2010-05-11,Haeundae,16000000,0,64733391,48733391,5,64733391,2010,304.58369375
2980,81,2010-03-09,Hachiko: A Dog's Story,16000000,0,47707417,31707417,3,47707417,2010,198.17135625
2981,82,2013-12-31,Zulu,16000000,0,1844228,-14155772,12,1844228,2013,-88.47357500000001
2982,83,2018-12-21,Second Act,15700000,39282227,63288854,47588854,12,24006627,2018,303.11371974522297
2983,84,2002-06-21,Juwanna Mann,15600000,13571817,13771817,-1828183,6,200000,2002,-11.719121794871795
2984,85,2007-06-08,La MÃ´me,15500000,10299782,88611837,73111837,6,78312055,2007,471.68927096774195
2985,86,2002-11-15,Ararat,15500000,1693000,1693000,-13807000,11,0,2002,-89.07741935483871
2986,87,2007-04-13,Slow Burn,15500000,1237615,1237615,-14262385,4,0,2007,-92.01538709677419
2987,88,2005-04-22,Madison,15500000,517262,517262,-14982738,4,0,2005,-96.66282580645161
2988,89,2010-02-26,The Yellow Handkerchief,15500000,318623,318623,-15181377,2,0,2010,-97.94436774193548
2989,90,2002-09-27,Wasabi,15300000,81525,7000000,-8300000,9,6918475,2002,-54.248366013071895
2990,91,2006-03-31,Slither,15250000,7802450,12930343,-2319657,3,5127893,2006,-15.21086557377049
2991,92,1990-11-16,Home Alone,15000000,285761243,476684675,461684675,11,190923432,1990,3077.8978333333334
2992,93,1984-12-05,Beverly Hills Cop,15000000,234760478,316300000,301300000,12,81539522,1984,2008.6666666666665
2993,94,1986-05-16,Top Gun,15000000,179800601,356799634,341799634,5,176999033,1986,2278.6642266666668
2994,95,1982-12-17,Tootsie,15000000,177200000,177200000,162200000,12,0,1982,1081.3333333333333
2995,96,1987-11-25,3 Men and a Baby,15000000,167780960,167780960,152780960,11,0,1987,1018.5397333333333
2996,97,2010-11-26,The Kingâs Speech,15000000,138797449,430821168,415821168,11,292023719,2010,2772.14112
2997,98,1999-09-15,American Beauty,15000000,130058047,356258047,341258047,9,226200000,1999,2275.0536466666667
2998,99,2000-12-08,"Crouching Tiger, Hidden Dragon",15000000,128067808,213514672,198514672,12,85446864,2000,1323.4311466666666
2999,100,1988-12-09,Twins,15000000,111936388,216600000,201600000,12,104663612,1988,1344.0
3000,1,1996-12-20,Scream,15000000,103046663,173046663,158046663,12,70000000,1996,1053.64442
3001,2,2017-08-11,Annabelle: Creation,15000000,102092201,305384865,290384865,8,203292664,2017,1935.8990999999999
3002,3,2013-10-25,Jackass Presents: Bad Grandpa,15000000,102003019,160903019,145903019,10,58900000,2013,972.6867933333333
3003,4,1978-06-28,Heaven Can Wait,15000000,98800000,98800000,83800000,6,0,1978,558.6666666666667
3004,5,1985-12-18,The Color Purple,15000000,93589701,93589701,78589701,12,0,1985,523.9313400000001
3005,6,2014-11-28,The Imitation Game,15000000,91125143,227740463,212740463,11,136615320,2014,1418.2697533333335
3006,7,1988-03-30,Beetlejuice,15000000,73839613,73887546,58887546,3,47933,1988,392.58364
3007,8,1959-11-18,Ben-Hur,15000000,73000000,73259017,58259017,11,259017,1959,388.39344666666665
3008,9,2013-01-18,Mama,15000000,71628180,148095566,133095566,1,76467386,2013,887.3037733333333
3009,10,1980-10-10,Private Benjamin,15000000,69847348,69847348,54847348,10,0,1980,365.64898666666664
3010,11,1980-03-07,Coal Miner's Daughter,15000000,67182787,67182787,52182787,3,0,1980,347.88524666666666
3011,12,1987-03-06,Lethal Weapon,15000000,65192350,120192350,105192350,3,55000000,1987,701.2823333333333
3012,13,2010-03-19,Diary of a Wimpy Kid,15000000,64003625,76954311,61954311,3,12950686,2010,413.02874
3013,14,1983-07-29,National Lampoonâs Vacation,15000000,61400000,61400000,46400000,7,0,1983,309.3333333333333
3014,15,2007-08-31,Halloween,15000000,58269151,77514401,62514401,8,19245250,2007,416.7626733333333
3015,16,2006-09-30,The Queen,15000000,56441711,128885873,113885873,9,72444162,2006,759.2391533333333
3016,17,2007-10-12,Why Did I Get Married?,15000000,55204525,55934178,40934178,10,729653,2007,272.89452
3017,18,2012-02-03,The Woman in Black,15000000,54333290,128955898,113955898,2,74622608,2012,759.7059866666667
3018,19,1994-12-21,Little Women,15000000,50003303,50003303,35003303,12,0,1994,233.3553533333333
3019,20,1979-01-01,The Deer Hunter,15000000,50000000,50009253,35009253,1,9253,1979,233.39502
3020,21,2018-08-10,BlacKkKlansman,15000000,49275340,93017335,78017335,8,43741995,2018,520.1155666666667
3021,22,2006-02-03,When a Stranger Calls,15000000,47860214,67215435,52215435,2,19355221,2006,348.1029
3022,23,2002-02-08,Big Fat Liar,15000000,47811275,52461017,37461017,2,4649742,2002,249.7401133333333
3023,24,1997-08-15,Cop Land,15000000,44906632,63706632,48706632,8,18800000,1997,324.71088
3024,25,1997-12-25,Wag the Dog,15000000,43057470,64252038,49252038,12,21194568,1997,328.34692
3025,26,2013-02-22,Snitch,15000000,42930462,57907734,42907734,2,14977272,2013,286.05156
3026,27,2003-05-02,The Lizzie McGuire Movie,15000000,42734455,55534455,40534455,5,12800000,2003,270.22970000000004
3027,28,2015-12-04,Krampus,15000000,42725475,61788393,46788393,12,19062918,2015,311.92262
3028,29,2012-09-21,End of Watch,15000000,41003371,57586606,42586606,9,16583235,2012,283.91070666666667
3029,30,1998-12-25,The Faculty,15000000,40283321,40283321,25283321,12,0,1998,168.55547333333334
3030,31,1993-06-09,What's Love Got to Do With It,15000000,39100956,39100956,24100956,6,0,1993,160.67304000000001
3031,32,2001-12-14,Not Another Teen Movie,15000000,37882551,62401343,47401343,12,24518792,2001,316.0089533333333
3032,33,2014-12-03,Wild,15000000,37880356,52460543,37460543,12,14580187,2014,249.73695333333333
3033,34,1962-12-16,Lawrence of Arabia,15000000,37495385,69995385,54995385,12,32500000,1962,366.6359
3034,35,2014-11-07,The Theory of Everything,15000000,35893537,123327692,108327692,11,87434155,2014,722.1846133333333
3035,36,2011-09-16,Drive,15000000,35060689,81357930,66357930,9,46297241,2011,442.3862
3036,37,2000-03-31,The Skulls,15000000,35007180,35007180,20007180,3,0,2000,133.3812
3037,38,1966-10-10,Hawaii,15000000,34562222,34562222,19562222,10,0,1966,130.41481333333334
3038,39,2018-11-23,The Favourite,15000000,34366783,94113929,79113929,11,59747146,2018,527.4261933333333
3039,40,2003-04-18,Malibu's Most Wanted,15000000,34308901,34499204,19499204,4,190303,2003,129.99469333333334
3040,41,2009-09-04,All About Steve,15000000,33862903,40127259,25127259,9,6264356,2009,167.51506
3041,42,2000-04-28,Where the Heart Is,15000000,33771174,40862054,25862054,4,7090880,2000,172.41369333333333
3042,43,2009-08-28,Halloween 2,15000000,33392973,38512850,23512850,8,5119877,2009,156.75233333333333
3043,44,2009-03-13,The Last House on the Left,15000000,32752215,46526243,31526243,3,13774028,2009,210.17495333333335
3044,45,2005-02-18,Because of Winn-Dixie,15000000,32647042,33508485,18508485,2,861443,2005,123.38990000000001
3045,46,2005-02-04,The Wedding Date,15000000,31726995,47175038,32175038,2,15448043,2005,214.50025333333335
3046,47,1987-09-25,The Princess Bride,15000000,30857000,30859628,15859628,9,2628,1987,105.73085333333334
3047,48,2002-07-12,Halloween: Resurrection,15000000,30259652,37659652,22659652,7,7400000,2002,151.06434666666667
3048,49,2007-12-25,The Great Debaters,15000000,30226144,30261293,15261293,12,35149,2007,101.74195333333333
3049,50,2014-08-22,When the Game Stands Tall,15000000,30127963,30138912,15138912,8,10949,2014,100.92608000000001
3050,51,1981-06-12,Clash of the Titans,15000000,30000000,44400000,29400000,6,14400000,1981,196.0
3051,52,2004-02-20,Confessions of a Teenage Drama Queen,15000000,29331068,33118854,18118854,2,3787786,2004,120.79236
3052,53,1998-04-17,The Object of my Affection,15000000,29145924,29145924,14145924,4,0,1998,94.30616
3053,54,2007-05-11,28 Weeks Later,15000000,28638916,64232714,49232714,5,35593798,2007,328.21809333333334
3054,55,1997-04-11,Grosse Pointe Blank,15000000,28084357,31070412,16070412,4,2986055,1997,107.13607999999999
3055,56,2000-04-21,Love and Basketball,15000000,27441122,27709625,12709625,4,268503,2000,84.73083333333334
3056,57,2017-09-08,Home Again,15000000,27020284,37336874,22336874,9,10316590,2017,148.91249333333334
3057,58,2000-10-27,Book of Shadows: Blair Witch 2,15000000,26421314,47721314,32721314,10,21300000,2000,218.14209333333335
3058,59,1997-10-10,Boogie Nights,15000000,26410771,43111725,28111725,10,16700954,1997,187.4115
3059,60,2010-07-23,Ramona and Beezus,15000000,26167002,27469621,12469621,7,1302619,2010,83.13080666666667
3060,61,2014-08-27,The November Man,15000000,25018119,34820335,19820335,8,9802216,2014,132.13556666666665
3061,62,1996-05-03,The Craft,15000000,24769466,55669466,40669466,5,30900000,1996,271.12977333333333
3062,63,2005-12-28,Match Point,15000000,23089926,87973835,72973835,12,64883909,2005,486.49223333333333
3063,64,1993-11-05,The Remains of the Day,15000000,22954968,63954968,48954968,11,41000000,1993,326.3664533333333
3064,65,1993-01-15,Nowhere to Run,15000000,22189039,52189039,37189039,1,30000000,1993,247.92692666666665
3065,66,2000-09-22,Urban Legends: Final Cut,15000000,21468807,38574362,23574362,9,17105555,2000,157.16241333333335
3066,67,2013-03-29,The Place Beyond the Pines,15000000,21403519,47011449,32011449,3,25607930,2013,213.40966
3067,68,2006-10-20,Flicka,15000000,21000147,21896367,6896367,10,896220,2006,45.97578
3068,69,2007-03-23,The Hills Have Eyes II,15000000,20804166,37466538,22466538,3,16662372,2007,149.77692
3069,70,2016-04-29,Keanu,15000000,20591853,20688141,5688141,4,96288,2016,37.920939999999995
3070,71,2010-12-22,Country Strong,15000000,20218921,20601987,5601987,12,383066,2010,37.34658
3071,72,2002-10-11,Tuck Everlasting,15000000,19161999,19344615,4344615,10,182616,2002,28.9641
3072,73,2006-10-13,The Marine,15000000,18844784,22165608,7165608,10,3320824,2006,47.77072
3073,74,1998-07-24,Disturbing Behavior,15000000,17507368,19014238,4014238,7,1506870,1998,26.761586666666666
3074,75,1998-03-06,The Big Lebowski,15000000,17498804,46189568,31189568,3,28690764,1998,207.93045333333336
3075,76,2014-07-25,A Most Wanted Man,15000000,17237855,36068890,21068890,7,18831035,2014,140.45926666666665
3076,77,2009-06-26,The Hurt Locker,15000000,17017811,49894223,34894223,6,32876412,2009,232.62815333333333
3077,78,2000-01-28,Eye of the Beholder,15000000,16500786,18260865,3260865,1,1760079,2000,21.7391
3078,79,2012-11-02,The Man with the Iron Fists,15000000,15634090,22018988,7018988,11,6384898,2012,46.79325333333333
3079,80,1984-05-11,Firestarter,15000000,15136870,15136870,136870,5,0,1984,0.9124666666666666
3080,81,2019-02-01,Miss Bala,15000000,14998027,15362298,362298,2,364271,2019,2.41532
3081,82,2012-11-30,Killing Them Softly,15000000,14945541,39238443,24238443,11,24292902,2012,161.58962
3082,83,2001-04-20,Freddy Got Fingered,15000000,14249005,14249005,-750995,4,0,2001,-5.006633333333333
3083,84,2011-08-19,One Day,15000000,13843771,59168692,44168692,8,45324921,2011,294.45794666666666
3084,85,2004-06-25,De-Lovely,15000000,13337299,18524496,3524496,6,5187197,2004,23.49664
3085,86,2009-10-02,Whip It,15000000,13077184,18889972,3889972,10,5812788,2009,25.93314666666667
3086,87,2008-01-11,The Pirates Who Don't Do Anything: A VeggieTales Movie,15000000,12981269,13248444,-1751556,1,267175,2008,-11.67704
3087,88,2008-01-23,U2 3D,15000000,12898847,26170402,11170402,1,13271555,2008,74.46934666666667
3088,89,2000-09-01,Highlander: Endgame,15000000,12801190,12801190,-2198810,9,0,2000,-14.658733333333332
3089,90,2017-01-20,The Founder,15000000,12786053,24403192,9403192,1,11617139,2017,62.68794666666667
3090,91,2006-08-25,Idlewild,15000000,12669914,12669914,-2330086,8,0,2006,-15.533906666666667
3091,92,2003-04-25,Confidence,15000000,12212417,12212417,-2787583,4,0,2003,-18.583886666666665
3092,93,2002-10-11,Knockaround Guys,15000000,11660180,12419700,-2580300,10,759520,2002,-17.202
3093,94,1999-08-27,The Muse,15000000,11614954,11614954,-3385046,8,0,1999,-22.566973333333333
3094,95,1998-04-03,Barney's Great Adventure,15000000,11156471,11156471,-3843529,4,0,1998,-25.623526666666667
3095,96,1989-03-01,New York Stories,15000000,10763469,10763469,-4236531,3,0,1989,-28.24354
3096,97,1998-11-25,Home Fries,15000000,10513979,10513979,-4486021,11,0,1998,-29.906806666666668
3097,98,2000-03-24,Here on Earth,15000000,10494147,10845127,-4154873,3,350980,2000,-27.69915333333333
3098,99,2004-10-08,Raise Your Voice,15000000,10411980,14811980,-188020,10,4400000,2004,-1.2534666666666667
3099,100,1985-12-18,Brazil,15000000,9929135,9932146,-5067854,12,3011,1985,-33.785693333333334
3100,1,1993-04-23,The Dark Half,15000000,9579068,9579068,-5420932,4,0,1993,-36.13954666666667
3101,2,2007-03-02,Black Snake Moan,15000000,9396870,10951153,-4048847,3,1554283,2007,-26.992313333333335
3102,3,2003-02-21,Dark Blue,15000000,9237470,12262065,-2737935,2,3024595,2003,-18.2529
3103,4,2007-06-22,A Mighty Heart,15000000,9176787,19153568,4153568,6,9976781,2007,27.69045333333333
3104,5,1983-09-30,Brainstorm,15000000,8921050,8921050,-6078950,9,0,1983,-40.52633333333333
3105,6,2016-09-23,Queen of Katwe,15000000,8874389,10055481,-4944519,9,1181092,2016,-32.96346
3106,7,2000-03-24,Whatever it Takes,15000000,8735529,8735529,-6264471,3,0,2000,-41.76314
3107,8,2003-03-21,Boat Trip,15000000,8586376,14933713,-66287,3,6347337,2003,-0.4419133333333334
3108,9,2002-05-22,The Importance of Being Earnest,15000000,8378141,8378141,-6621859,5,0,2002,-44.14572666666667
3109,10,1999-05-21,The Love Letter,15000000,8322608,9010980,-5989020,5,688372,1999,-39.9268
3110,11,2006-05-05,Hoot,15000000,8117637,8224998,-6775002,5,107361,2006,-45.16668
3111,12,2008-02-08,In Bruges,15000000,7800825,34533783,19533783,2,26732958,2008,130.22522
3112,13,2013-01-04,Promised Land,15000000,7597898,12394562,-2605438,1,4796664,2013,-17.369586666666667
3113,14,2001-10-08,Mulholland Drive,15000000,7219578,20785973,5785973,10,13566395,2001,38.57315333333333
3114,15,2018-06-08,Hotel Artemis,15000000,6708137,12758799,-2241201,6,6050662,2018,-14.94134
3115,16,2008-08-20,The Rocker,15000000,6409528,8767338,-6232662,8,2357810,2008,-41.55108
3116,17,2009-08-21,Post Grad,15000000,6382178,6563402,-8436598,8,181224,2009,-56.243986666666665
3117,18,2009-06-19,Whatever Works,15000000,5306706,35106706,20106706,6,29800000,2009,134.04470666666666
3118,19,2000-07-19,The In Crowd,15000000,5217498,5217498,-9782502,7,0,2000,-65.21668000000001
3119,20,2005-12-14,Los tres entierros de Melquiades Estrada,15000000,5027684,13454474,-1545526,12,8426790,2005,-10.303506666666665
3120,21,1999-09-24,Jakob the Liar,15000000,4956401,4956401,-10043599,9,0,1999,-66.95732666666667
3121,22,2007-09-28,Se jie,15000000,4604982,65167430,50167430,9,60562448,2007,334.4495333333333
3122,23,2005-10-21,"Kiss Kiss, Bang Bang",15000000,4235837,16829464,1829464,10,12593627,2005,12.196426666666667
3123,24,1999-04-30,Idle Hands,15000000,4023741,4023741,-10976259,4,0,1999,-73.17506
3124,25,2015-10-30,Scouts Guide to the Zombie Apocalypse,15000000,3703046,15554855,554855,10,11851809,2015,3.6990333333333334
3125,26,2007-01-26,Blood and Chocolate,15000000,3526588,6551310,-8448690,1,3024722,2007,-56.324600000000004
3126,27,2010-09-22,You Will Meet a Tall Dark Stranger,15000000,3247816,34247816,19247816,9,31000000,2010,128.31877333333333
3127,28,2015-10-23,Rock the Kasbah,15000000,3020665,3386153,-11613847,10,365488,2015,-77.42564666666667
3128,29,2010-09-15,Never Let Me Go,15000000,2434652,11173718,-3826282,9,8739066,2010,-25.508546666666664
3129,30,2016-09-09,The Disappointments Room,15000000,2423467,3503761,-11496239,9,1080294,2016,-76.64159333333333
3130,31,2003-12-25,The Company,15000000,2281585,3396508,-11603492,12,1114923,2003,-77.35661333333333
3131,32,2008-07-18,Transsiberian,15000000,2203641,6379575,-8620425,7,4175934,2008,-57.4695
3132,33,1999-10-22,Crazy in Alabama,15000000,1954202,1954202,-13045798,10,0,1999,-86.97198666666667
3133,34,1986-01-17,The Clan of the Cave Bear,15000000,1953732,1953732,-13046268,1,0,1986,-86.97511999999999
3134,35,2017-02-03,The Comedian,15000000,1658706,1658706,-13341294,2,0,2017,-88.94196
3135,36,2008-03-14,Funny Games,15000000,1294640,8200127,-6799873,3,6905487,2008,-45.33248666666667
3136,37,2006-06-02,Banlieue 13,15000000,1200216,11599903,-3400097,6,10399687,2006,-22.667313333333333
3137,38,1999-11-12,Felicia's Journey,15000000,824295,1970268,-13029732,11,1145973,1999,-86.86488
3138,39,2002-01-25,Metropolis,15000000,673414,1405032,-13594968,1,731618,2002,-90.63312
3139,40,2015-10-16,CÃ¬kÃ¨ NiÃ¨ YinniÃ¡ng,15000000,632542,11279884,-3720116,10,10647342,2015,-24.800773333333336
3140,41,1995-12-01,Things to Do in Denver when You're Dead,15000000,529766,529766,-14470234,12,0,1995,-96.46822666666667
3141,42,2013-04-26,The Reluctant Fundamentalist,15000000,528731,528731,-14471269,4,0,2013,-96.47512666666667
3142,43,2004-02-06,The Return,15000000,501752,5953886,-9046114,2,5452134,2004,-60.307426666666665
3143,44,2003-07-25,Buffalo Soldiers,15000000,353743,353743,-14646257,7,0,2003,-97.64171333333334
3144,45,2003-04-25,Steal (Canadian Release),15000000,220944,220944,-14779056,4,0,2003,-98.52704
3145,46,2010-08-27,Centurion,15000000,123570,7885048,-7114952,8,7761478,2010,-47.433013333333335
3146,47,2009-10-23,Ong-Bak 2,15000000,102458,7583050,-7416950,10,7480592,2009,-49.44633333333333
3147,48,1996-12-31,Silent Trigger,15000000,76382,76382,-14923618,12,0,1996,-99.49078666666666
3148,49,2008-08-01,Midnight Meat Train,15000000,73548,1590246,-13409754,8,1516698,2008,-89.39836
3149,50,2013-09-06,Winnie Mandela,15000000,61847,61847,-14938153,9,0,2013,-99.58768666666667
3150,51,2011-11-04,The Son of No One,15000000,30680,1148578,-13851422,11,1117898,2011,-92.34281333333332
3151,52,2002-10-25,All the Queen's Men,15000000,22723,22723,-14977277,10,0,2002,-99.84851333333333
3152,53,2007-10-05,The Good Night,15000000,22441,22441,-14977559,10,0,2007,-99.85039333333333
3153,54,2013-12-06,Khumba,15000000,0,20898221,5898221,12,20898221,2013,39.32147333333334
3154,55,2015-05-05,A Few Best Men,15000000,0,17224539,2224539,5,17224539,2015,14.83026
3155,56,2014-10-10,AutÃ³mata,15000000,0,6775458,-8224542,10,6775458,2014,-54.830279999999995
3156,57,2015-12-31,Chiamatemi Francesco - Il papa della gente,15000000,0,3925769,-11074231,12,3925769,2015,-73.82820666666666
3157,58,2008-12-31,Bathory,15000000,0,3436763,-11563237,12,3436763,2008,-77.08824666666668
3158,59,2010-02-05,San suk si gin,15000000,0,2013340,-12986660,2,2013340,2010,-86.57773333333333
3159,60,2005-12-31,Dungeons & Dragons: Wrath of the Dragon God,15000000,0,909822,-14090178,12,909822,2005,-93.93451999999999
3160,61,2017-02-17,In Dubious Battle,15000000,0,214182,-14785818,2,214182,2017,-98.57212
3161,62,2015-09-01,Broken Horses,15000000,0,3471,-14996529,9,3471,2015,-99.97686
3162,63,2001-06-29,Pandaemonium,15000000,0,0,-15000000,6,0,2001,-100.0
3163,64,2019-08-14,Blinded by the Light,15000000,0,0,-15000000,8,0,2019,-100.0
3164,65,1993-02-12,Groundhog Day,14600000,70906973,70906973,56306973,2,0,1993,385.664198630137
3165,66,2015-07-01,Magic Mike XXL,14500000,66013057,123660597,109160597,7,57647540,2015,752.8317034482758
3166,67,1996-11-01,Romeo+Juliet,14500000,46338728,147542381,133042381,11,101203653,1996,917.5336620689656
3167,68,2011-07-22,Elle s'appelait Sarah,14500000,7691700,25480031,10980031,7,17788331,2011,75.72435172413793
3168,69,2015-06-05,Freedom,14500000,0,872757,-13627243,6,872757,2015,-93.98098620689656
3169,70,1992-08-07,Unforgiven,14400000,101157447,159157447,144757447,8,58000000,1992,1005.2600486111111
3170,71,2006-01-27,Manderlay,14200000,74205,543306,-13656694,1,469101,2006,-96.1739014084507
3171,72,1990-03-23,Pretty Woman,14000000,178406268,432645872,418645872,3,254239604,1990,2990.327657142857
3172,73,1987-09-18,Fatal Attraction,14000000,156645693,320100000,306100000,9,163454307,1987,2186.4285714285716
3173,74,2008-11-12,Slumdog Millionaire,14000000,141330703,384530440,370530440,11,243199737,2008,2646.646
3174,75,1974-12-17,Towering Inferno,14000000,116000000,139700000,125700000,12,23700000,1974,897.8571428571428
3175,76,1988-05-25,Crocodile Dundee 2,14000000,109306210,239606210,225606210,5,130300000,1988,1611.4729285714286
3176,77,1989-12-20,Born on the Fourth of July,14000000,70001698,70001698,56001698,12,0,1989,400.0121285714286
3177,78,1993-10-01,Cool Runnings,14000000,68856263,155056263,141056263,10,86200000,1993,1007.5447357142858
3178,79,2007-01-12,Stomp the Yard,14000000,61356221,75525718,61525718,1,14169497,2007,439.46941428571427
3179,80,2009-01-16,My Bloody Valentine,14000000,51545952,102836002,88836002,1,51290050,2009,634.5428714285714
3180,81,2012-08-31,The Possession,14000000,49130588,82925064,68925064,8,33794476,2012,492.32188571428577
3181,82,1982-10-22,First Blood,14000000,47212904,125212904,111212904,10,78000000,1982,794.3778857142858
3182,83,1977-07-13,The Spy Who Loved Me,14000000,46800000,185400000,171400000,7,138600000,1977,1224.2857142857142
3183,84,1998-09-25,Urban Legend,14000000,38116707,72571864,58571864,9,34455157,1998,418.37045714285716
3184,85,1981-12-09,Taps,14000000,35856053,35856053,21856053,12,0,1981,156.11466428571427
3185,86,2012-02-24,Tyler Perry's Good Deeds,14000000,35025791,35579177,21579177,2,553386,2012,154.13697857142856
3186,87,1991-01-18,White Fang,14000000,34729091,34729091,20729091,1,0,1991,148.06493571428572
3187,88,1988-12-21,Dangerous Liaisons,14000000,34700000,34700000,20700000,12,0,1988,147.85714285714286
3188,89,1999-10-08,Superstar,14000000,30628981,30628981,16628981,10,0,1999,118.77843571428572
3189,90,2012-01-13,The Iron Lady,14000000,29959436,115592104,101592104,1,85632668,2012,725.6578857142857
3190,91,1993-07-23,Poetic Justice,14000000,27450453,27450453,13450453,7,0,1993,96.07466428571428
3191,92,2002-10-04,Jonah: A VeggieTales Movie,14000000,25571351,25608779,11608779,10,37428,2002,82.91985
3192,93,2002-03-08,All About the Benjamins,14000000,25482931,25873145,11873145,3,390214,2002,84.80817857142857
3193,94,1977-06-17,Exorcist II: The Heretic,14000000,25011000,25011000,11011000,6,0,1977,78.64999999999999
3194,95,2010-03-12,Our Family Wedding,14000000,20255281,21410546,7410546,3,1155265,2010,52.932471428571425
3195,96,1995-10-27,Vampire in Brooklyn,14000000,19637147,19637147,5637147,10,0,1995,40.26533571428572
3196,97,2006-05-05,An American Haunting,14000000,16298046,30443277,16443277,5,14145231,2006,117.45197857142857
3197,98,2003-08-22,My Boss's Daughter,14000000,15549702,15549702,1549702,8,0,2003,11.0693
3198,99,2009-08-07,A Perfect Getaway,14000000,15515460,22815460,8815460,8,7300000,2009,62.96757142857143
3199,100,1996-10-25,Thinner,14000000,15171475,15171475,1171475,10,0,1996,8.367678571428572
3200,1,1998-08-21,Dead Man on Campus,14000000,15064948,15064948,1064948,8,0,1998,7.606771428571428
3201,2,1999-05-14,Tea with Mussolini,14000000,14395874,14395874,395874,5,0,1999,2.8276714285714286
3202,3,1977-06-22,"New York, New York",14000000,13800000,13800000,-200000,6,0,1977,-1.4285714285714286
3203,4,2002-04-26,Jason X,14000000,13121555,16951798,2951798,4,3830243,2002,21.084271428571427
3204,5,1994-05-13,Crooklyn,14000000,13024170,13024170,-975830,5,0,1994,-6.9702142857142855
3205,6,2007-03-16,I Think I Love My Wife,14000000,12559771,13205411,-794589,3,645640,2007,-5.675635714285714
3206,7,2015-02-20,Hot Tub Time Machine 2,14000000,12314651,12826644,-1173356,2,511993,2015,-8.381114285714286
3207,8,2006-11-17,Bobby,14000000,11242801,20597806,6597806,11,9355005,2006,47.127185714285716
3208,9,2001-02-02,Head Over Heels,14000000,10397365,10397365,-3602635,2,0,2001,-25.733107142857143
3209,10,2012-10-26,Fun Size,14000000,9409538,11166615,-2833385,10,1757077,2012,-20.238464285714286
3210,11,1999-04-23,Lost and Found,14000000,6552255,6552255,-7447745,4,0,1999,-53.19817857142857
3211,12,2007-11-30,Le Scaphandre et le Papillon,14000000,5990075,22754472,8754472,11,16764397,2007,62.53194285714285
3212,13,2006-10-06,Little Children,14000000,5463019,14121177,121177,10,8658158,2006,0.86555
3213,14,2000-04-21,Gossip,14000000,5108820,12591270,-1408730,4,7482450,2000,-10.062357142857142
3214,15,1999-03-26,A Walk on the Moon,14000000,4741987,4741987,-9258013,3,0,1999,-66.1286642857143
3215,16,2015-10-23,Suffragette,14000000,4702420,34044909,20044909,10,29342489,2015,143.1779214285714
3216,17,2006-10-27,Catch a Fire,14000000,4299773,5782198,-8217802,10,1482425,2006,-58.69858571428571
3217,18,2014-12-19,Mr. Turner,14000000,3958546,25187026,11187026,12,21228480,2014,79.90732857142856
3218,19,2001-09-07,Soul Survivors,14000000,3100650,4288246,-9711754,9,1187596,2001,-69.36967142857144
3219,20,2009-05-22,Easy Virtue,14000000,2656784,20537741,6537741,5,17880957,2009,46.69815
3220,21,1995-03-31,Jefferson in Paris,14000000,2461628,2461628,-11538372,3,0,1995,-82.41694285714286
3221,22,2010-08-06,Flipped,14000000,1755212,4289993,-9710007,8,2534781,2010,-69.35719285714286
3222,23,1978-01-01,Caravans,14000000,1000000,1000000,-13000000,1,0,1978,-92.85714285714286
3223,24,2010-06-25,Les herbes folles,14000000,403952,1903952,-12096048,6,1500000,2010,-86.40034285714286
3224,25,2003-01-24,Amen,14000000,274299,274299,-13725701,1,0,2003,-98.04072142857143
3225,26,2008-09-26,The Lucky Ones,14000000,266967,266967,-13733033,9,0,2008,-98.09309285714286
3226,27,2011-09-30,Margaret,14000000,47185,623292,-13376708,9,576107,2011,-95.54791428571428
3227,28,2016-11-01,Reign of Assassins,14000000,0,11354230,-2645770,11,11354230,2016,-18.89835714285714
3228,29,2009-10-27,Stan Helsing: A Parody,14000000,0,1553556,-12446444,10,1553556,2009,-88.90317142857143
3229,30,2005-12-09,Brokeback Mountain,13900000,83043761,176980863,163080863,12,93937102,2005,1173.243618705036
3230,31,1995-07-01,Clueless,13700000,56598476,56598476,42898476,7,0,1995,313.1275620437956
3231,32,2008-12-31,Ca$h,13700000,0,11738256,-1961744,12,11738256,2008,-14.319299270072994
3232,33,1990-03-30,Teenage Mutant Ninja Turtles,13500000,135265915,202000000,188500000,3,66734085,1990,1396.2962962962963
3233,34,1956-10-05,The Ten Commandments,13500000,85400591,85434516,71934516,10,33925,1956,532.8482666666667
3234,35,2002-11-08,Far From Heaven,13500000,15901849,29027914,15527914,11,13126065,2002,115.02158518518519
3235,36,2012-10-12,Seven Psychopaths,13500000,15024049,33035736,19535736,10,18011687,2012,144.70915555555555
3236,37,2000-11-22,Quills,13500000,7060876,11732088,-1767912,11,4671212,2000,-13.095644444444442
3237,38,1982-01-29,The Border,13500000,6118683,6118683,-7381317,1,0,1982,-54.67642222222222
3238,39,2005-02-18,Der Untergang,13500000,5501940,93631744,80131744,2,88129804,2005,593.5684740740741
3239,40,2001-03-02,The Caveman's Valentine,13500000,687081,892506,-12607494,3,205425,2001,-93.38884444444444
3240,41,2011-04-01,The Last Godfather,13400000,164247,164247,-13235753,4,0,2011,-98.77427611940298
3241,42,2014-04-04,Under the Skin,13300000,2614251,7229933,-6070067,4,4615682,2014,-45.639601503759394
3242,43,2004-12-17,Mar adentro,13300000,2086345,39686345,26386345,12,37600000,2004,198.39357142857145
3243,44,2014-09-12,No Good Deed,13200000,52543632,54323210,41123210,9,1779578,2014,311.53946969696966
3244,45,1987-12-23,Good Morning Vietnam,13000000,123922370,123922370,110922370,12,0,1987,853.2489999999999
3245,46,2010-12-03,Black Swan,13000000,106954678,331266710,318266710,12,224312032,2010,2448.205461538462
3246,47,2001-01-12,Save the Last Dance,13000000,91038276,122244329,109244329,1,31206053,2001,840.3409923076923
3247,48,2011-02-11,Justin Bieber: Never Say Never,13000000,73013910,99034125,86034125,2,26020215,2011,661.8009615384615
3248,49,2018-07-04,The First Purge,13000000,69488745,136617305,123617305,7,67128560,2018,950.9023461538461
3249,50,2016-03-16,Miracles from Heaven,13000000,61705123,73798736,60798736,3,12093613,2016,467.68258461538466
3250,51,2000-02-11,Snow Day,13000000,60008303,62452927,49452927,2,2444624,2000,380.4071307692308
3251,52,2004-01-23,The Butterfly Effect,13000000,57924679,95638592,82638592,1,37713913,2004,635.6814769230768
3252,53,1974-12-11,The Godfather: Part II,13000000,57300000,57300000,44300000,12,0,1974,340.7692307692308
3253,54,2016-06-24,The Shallows,13000000,55121623,118763442,105763442,6,63641819,2016,813.5649384615384
3254,55,1987-07-17,RoboCop,13000000,53424681,53424681,40424681,7,0,1987,310.9590846153846
3255,56,1988-08-19,A Nightmare on Elm Street 4: The Dream Master,13000000,49369899,49369899,36369899,8,0,1988,279.7684538461538
3256,57,2007-11-21,This Christmas,13000000,49121934,49733545,36733545,11,611611,2007,282.56573076923075
3257,58,2014-02-14,About Last Night,13000000,48637684,50445860,37445860,2,1808176,2014,288.0450769230769
3258,59,2000-12-15,"Dude, Where's My Car?",13000000,46729374,73180297,60180297,12,26450923,2000,462.9253615384616
3259,60,1988-08-12,Young Guns,13000000,44726644,44726644,31726644,8,0,1988,244.0511076923077
3260,61,2014-10-10,St. Vincent,13000000,44137712,54837234,41837234,10,10699522,2014,321.82487692307694
3261,62,2014-07-02,Earth to Echo,13000000,38934842,42174545,29174545,7,3239703,2014,224.41957692307693
3262,63,1999-03-31,10 Things I Hate About You,13000000,38177966,60413950,47413950,3,22235984,1999,364.72269230769234
3263,64,2002-05-10,The New Guy,13000000,28972187,28972187,15972187,5,0,2002,122.86297692307693
3264,65,1993-02-05,Loaded Weapon 1,13000000,27979399,27979399,14979399,2,0,1993,115.22614615384614
3265,66,1999-03-12,Baby Geniuses,13000000,27151490,27151490,14151490,3,0,1999,108.85761538461539
3266,67,1998-04-24,The Big Hit,13000000,27066941,27066941,14066941,4,0,1998,108.20723846153845
3267,68,1990-11-09,Child's Play 2,13000000,26904572,34166572,21166572,11,7262000,1990,162.81978461538463
3268,69,1996-07-10,Harriet the Spy,13000000,26570048,26570048,13570048,7,0,1996,104.38498461538461
3269,70,2013-03-01,21 and Over,13000000,25682380,42195766,29195766,3,16513386,2013,224.5828153846154
3270,71,2007-11-21,The Mist,13000000,25593755,57189408,44189408,11,31595653,2007,339.9185230769231
3271,72,2015-04-10,Ex Machina,13000000,25440971,38358392,25358392,4,12917421,2015,195.06455384615384
3272,73,1999-10-29,Being John Malkovich,13000000,22858926,32382381,19382381,10,9523455,1999,149.09523846153846
3273,74,2001-09-07,Two Can Play That Game,13000000,22235901,22391450,9391450,9,155549,2001,72.24192307692307
3274,75,2016-03-11,Eye in the Sky,13000000,18704596,35402802,22402802,3,16698206,2016,172.32924615384616
3275,76,2013-03-22,Admission,13000000,18007317,18733666,5733666,3,726349,2013,44.10512307692308
3276,77,2012-09-21,The Perks of Being a Wallflower,13000000,17742948,33069303,20069303,9,15326355,2012,154.37925384615386
3277,78,2001-06-29,crazy/beautiful,13000000,16929123,19929123,6929123,6,3000000,2001,53.300946153846155
3278,79,1998-08-28,54,13000000,16757163,16757163,3757163,8,0,1998,28.901253846153846
3279,80,2015-10-16,Room,13000000,14677674,36262783,23262783,10,21585109,2015,178.94448461538462
3280,81,2015-10-16,Woodlawn,13000000,14394097,14403703,1403703,10,9606,2015,10.797715384615385
3281,82,2006-12-20,Letters from Iwo Jima,13000000,13756082,67867998,54867998,12,54111916,2006,422.0615230769231
3282,83,2009-05-29,MÃ¤n som hatar kvinnor,13000000,12749992,109421911,96421911,5,96671919,2009,741.7070076923077
3283,84,2007-02-23,The Astronaut Farmer,13000000,11003643,11141213,-1858787,2,137570,2007,-14.298361538461538
3284,85,1998-06-12,Dirty Work,13000000,10020081,10020081,-2979919,6,0,1998,-22.922453846153847
3285,86,2015-07-17,Bajrangi Bhaijaan,13000000,8178001,121778347,108778347,7,113600346,2015,836.7565153846155
3286,87,1998-05-08,Woo,13000000,8064972,8064972,-4935028,5,0,1998,-37.96175384615385
3287,88,2016-09-09,Robinson Crusoe,13000000,8005586,42446455,29446455,9,34440869,2016,226.5111923076923
3288,89,1994-04-13,Serial Mom,13000000,7881335,7881335,-5118665,4,0,1994,-39.374346153846155
3289,90,1999-08-04,Dick,13000000,6276869,6276869,-6723131,8,0,1999,-51.7163923076923
3290,91,1999-11-10,Light It Up,13000000,5871603,5871603,-7128397,11,0,1999,-54.833823076923075
3291,92,2001-08-24,Bubble Boy,13000000,5002310,5002310,-7997690,8,0,2001,-61.5206923076923
3292,93,2002-02-01,Birthday Girl,13000000,4919896,8130727,-4869273,2,3210831,2002,-37.455946153846156
3293,94,2007-05-04,"Paris, je t'aime",13000000,4857374,5175088,-7824912,5,317714,2007,-60.19163076923076
3294,95,2018-12-07,Ben is Back,13000000,3703182,9633111,-3366889,12,5929929,2018,-25.899146153846154
3295,96,2007-08-24,Resurrecting the Champ,13000000,3172382,3260555,-9739445,8,88173,2007,-74.91880769230768
3296,97,2010-03-26,Chloe,13000000,3075255,11831131,-1168869,3,8755876,2010,-8.9913
3297,98,2001-03-02,The Widow of St. Pierre,13000000,3058380,3058380,-9941620,3,0,2001,-76.474
3298,99,2015-12-04,Youth,13000000,2703296,24001573,11001573,12,21298277,2015,84.62748461538462
3299,100,1996-04-05,Faithful,13000000,2104439,2104439,-10895561,4,0,1996,-83.81200769230769
3300,1,2010-02-26,Un ProphÃ¨te,13000000,2087720,19910624,6910624,2,17822904,2010,53.158646153846156
3301,2,2010-12-03,"I Love You, Phillip Morris",13000000,2037459,23014027,10014027,12,20976568,2010,77.03097692307692
3302,3,2015-07-24,The Vatican Tapes,13000000,1784763,14929184,1929184,7,13144421,2015,14.839876923076922
3303,4,2006-03-17,Find Me Guilty,13000000,1173673,2898225,-10101775,3,1724552,2006,-77.70596153846154
3304,5,1993-05-14,Excessive Force,13000000,1152117,1152117,-11847883,5,0,1993,-91.13756153846154
3305,6,2006-10-13,Infamous,13000000,1151330,2613717,-10386283,10,1462387,2006,-79.89448461538461
3306,7,2011-07-29,Attack the Block,13000000,1024175,6459183,-6540817,7,5435008,2011,-50.31397692307692
3307,8,2015-08-14,Brothers,13000000,656688,17856688,4856688,8,17200000,2015,37.35913846153846
3308,9,2000-12-29,The Claim,13000000,622023,1375635,-11624365,12,753612,2000,-89.41819230769231
3309,10,2011-12-23,In The Land of Blood and Honey,13000000,303877,509193,-12490807,12,205316,2011,-96.08313076923078
3310,11,2010-06-18,The Killer Inside Me,13000000,217277,3617277,-9382723,6,3400000,2010,-72.1747923076923
3311,12,2012-03-30,Womb,13000000,0,0,-13000000,3,0,2012,-100.0
3312,13,2019-12-31,Rogue City,13000000,0,0,-13000000,12,0,2019,-100.0
3313,14,2013-03-15,The Call,12800000,51872378,69821476,57021476,3,17949098,2013,445.48028124999996
3314,15,2016-08-05,Operation Chromite,12700000,1022720,49196532,36496532,8,48173812,2016,287.3742677165354
3315,16,2014-09-12,The Drop,12600000,10724389,19054534,6454534,9,8330145,2014,51.22646031746032
3316,17,2002-07-12,The Crocodile Hunter: Collision Course,12500000,28436931,33436931,20936931,7,5000000,2002,167.495448
3317,18,2010-09-03,Machete,12500000,26593646,46370970,33870970,9,19777324,2010,270.96776
3318,19,2002-12-19,Antwone Fisher,12500000,21078145,23367586,10867586,12,2289441,2002,86.940688
3319,20,1982-02-12,La Guerre du feu,12500000,20959585,20959585,8459585,2,0,1982,67.67668
3320,21,2002-11-22,The Emperor's Club,12500000,14060950,16193713,3693713,11,2132763,2002,29.549704
3321,22,1993-09-10,True Romance,12500000,12281000,12309980,-190020,9,28980,1993,-1.52016
3322,23,2009-09-11,Sorority Row,12500000,11965282,26735797,14235797,9,14770515,2009,113.886376
3323,24,1992-09-30,Glengarry Glen Ross,12500000,10725228,10725228,-1774772,9,0,1992,-14.198176000000002
3324,25,2008-11-07,The Boy in the Striped Pyjamas,12500000,9046156,44083403,31583403,11,35037247,2008,252.66722399999998
3325,26,1982-04-02,Cat People,12500000,7000000,21000000,8500000,4,14000000,1982,68.0
3326,27,1979-05-25,The Prisoner of Zenda,12500000,7000000,7000000,-5500000,5,0,1979,-44.0
3327,28,2010-10-15,Conviction,12500000,6797696,11826980,-673020,10,5029284,2010,-5.3841600000000005
3328,29,2007-10-12,Lars and the Real Girl,12500000,5956480,11277119,-1222881,10,5320639,2007,-9.783047999999999
3329,30,2010-05-21,Solitary Man,12500000,4360548,4360548,-8139452,5,0,2010,-65.115616
3330,31,2000-09-22,Dancer in the Dark,12500000,4157491,45557491,33057491,9,41400000,2000,264.459928
3331,32,2010-12-17,Casino Jack,12500000,2039869,2272186,-10227814,12,232317,2010,-81.822512
3332,33,1997-12-31,Oscar and Lucinda,12500000,1612957,1612957,-10887043,12,0,1997,-87.096344
3333,34,1996-11-01,The Funeral,12500000,1212799,1412799,-11087201,11,200000,1996,-88.69760799999999
3334,35,2004-09-03,Tae Guik Gi: The Brotherhood of War,12500000,1110186,69826708,57326708,9,68716522,2004,458.613664
3335,36,2010-04-16,The Perfect Game,12500000,1089445,3931367,-8568633,4,2841922,2010,-68.549064
3336,37,2012-10-05,The Paperboy,12500000,677200,4027663,-8472337,10,3350463,2012,-67.77869600000001
3337,38,2013-03-01,Ernest et Celestine,12500000,292562,9376444,-3123556,3,9083882,2013,-24.988447999999998
3338,39,2012-05-04,A Little Bit of Heaven,12500000,10011,1100287,-11399713,5,1090276,2012,-91.197704
3339,40,1988-11-18,The Land Before Time,12300000,48092846,81972846,69672846,11,33880000,1988,566.4459024390244
3340,41,1975-06-20,Jaws,12000000,260000000,470700000,458700000,6,210700000,1975,3822.5
3341,42,1973-12-26,The Exorcist,12000000,230347346,428214478,416214478,12,197867132,1973,3468.4539833333333
3342,43,2014-06-06,The Fault in Our Stars,12000000,124872350,307166834,295166834,6,182294484,2014,2459.7236166666667
3343,44,1999-07-09,American Pie,12000000,101800948,234723148,222723148,7,132922200,1999,1856.0262333333335
3344,45,2012-04-20,Think Like a Man,12000000,91547205,113373764,101373764,4,21826559,2012,844.7813666666667
3345,46,2014-04-16,Heaven is for Real,12000000,91386097,100916299,88916299,4,9530202,2014,740.9691583333333
3346,47,1986-12-12,The Golden Child,12000000,79817937,79817937,67817937,12,0,1986,565.149475
3347,48,1982-06-04,Star Trek II: The Wrath of Khan,12000000,78912963,95800000,83800000,6,16887037,1982,698.3333333333334
3348,49,2002-09-13,Barbershop,12000000,75781642,77063461,65063461,9,1281819,2002,542.1955083333334
3349,50,1983-06-03,WarGames,12000000,74433837,74433837,62433837,6,0,1983,520.281975
3350,51,1994-02-04,Ace Ventura: Pet Detective,12000000,72217396,107217396,95217396,2,35000000,1994,793.4783
3351,52,2012-02-24,Act of Valor,12000000,70012847,82497035,70497035,2,12484188,2012,587.4752916666667
3352,53,1985-02-08,Witness,12000000,65532576,65532576,53532576,2,0,1985,446.1048
3353,54,2006-08-11,Step Up,12000000,65328121,110989157,98989157,8,45661036,2006,824.9096416666667
3354,55,2012-02-03,Chronicle,12000000,64575175,123681790,111681790,2,59106615,2012,930.6815833333334
3355,56,1996-12-20,Beavis and Butt-Head Do America,12000000,63118386,63118386,51118386,12,0,1996,425.98655
3356,57,1970-01-01,Patton,12000000,62500000,62500000,50500000,1,0,1970,420.8333333333333
3357,58,2012-03-02,Project X,12000000,54731865,103028188,91028188,3,48296323,2012,758.5682333333334
3358,59,2017-11-10,"Three Billboards Outside Ebbing, Missouri",12000000,54513740,160191915,148191915,11,105678175,2017,1234.9326250000001
3359,60,2016-11-25,Lion,12000000,51739495,149570720,137570720,11,97831225,2016,1146.4226666666666
3360,61,2018-05-04,Overboard,12000000,50316123,85369830,73369830,5,35053707,2018,611.41525
3361,62,1997-12-25,Jackie Brown,12000000,39673162,74727492,62727492,12,35054330,1997,522.7291
3362,63,1983-11-18,Yentl,12000000,39012241,39012241,27012241,11,0,1983,225.10200833333332
3363,64,2008-04-25,Harold & Kumar Escape from Guantanamo Bay,12000000,38108728,43353117,31353117,4,5244389,2008,261.275975
3364,65,2013-11-22,Philomena,12000000,37709979,98963392,86963392,11,61253413,2013,724.6949333333333
3365,66,1981-11-06,Time Bandits,12000000,37400000,37400000,25400000,11,0,1981,211.66666666666666
3366,67,2002-02-15,Crossroads,12000000,37188667,57000000,45000000,2,19811333,2002,375.0
3367,68,2015-07-24,Paper Towns,12000000,32000304,85450484,73450484,7,53450180,2015,612.0873666666666
3368,69,2008-10-10,Quarantine,12000000,31691811,41924774,29924774,10,10232963,2008,249.37311666666665
3369,70,2002-08-21,One Hour Photo,12000000,31597131,52223306,40223306,8,20626175,2002,335.19421666666665
3370,71,2008-02-01,The Eye,12000000,31418697,57577765,45577765,2,26159068,2008,379.81470833333333
3371,72,2004-04-07,Johnson Family Vacation,12000000,31203964,31286759,19286759,4,82795,2004,160.72299166666667
3372,73,2001-12-21,How High,12000000,31155435,31222395,19222395,12,66960,2001,160.186625
3373,74,1960-10-07,Spartacus,12000000,30000000,60000000,48000000,10,30000000,1960,400.0
3374,75,2006-09-01,Crank,12000000,27838408,43924923,31924923,9,16086515,2006,266.041025
3375,76,1992-12-11,The Muppet Christmas Carol,12000000,27281507,27492918,15492918,12,211411,1992,129.10765
3376,77,2016-08-12,Hell or High Water,12000000,27007844,37584304,25584304,8,10576460,2016,213.20253333333335
3377,78,2002-10-25,Frida,12000000,25885000,56131239,44131239,10,30246239,2002,367.760325
3378,79,2012-07-05,Katy Perry: Part of Me,12000000,25326071,32700439,20700439,7,7374368,2012,172.50365833333333
3379,80,2014-12-12,Top Five,12000000,25317379,26001741,14001741,12,684362,2014,116.681175
3380,81,1998-09-11,Rounders,12000000,22921898,22921898,10921898,9,0,1998,91.01581666666667
3381,82,1967-04-28,Casino Royale,12000000,22744718,41744718,29744718,4,19000000,1967,247.87265
3382,83,1979-06-15,Prophecy,12000000,22673340,22673340,10673340,6,0,1979,88.9445
3383,84,2015-01-30,Project Almanac,12000000,22348241,32909437,20909437,1,10561196,2015,174.24530833333333
3384,85,2010-05-14,Just Wright,12000000,21540363,21867665,9867665,5,327302,2010,82.23054166666667
3385,86,1999-09-10,Stir of Echoes,12000000,21133087,21133087,9133087,9,0,1999,76.10905833333334
3386,87,1995-01-13,Tales from the Crypt: Demon Knight,12000000,21089146,21089146,9089146,1,0,1995,75.74288333333334
3387,88,1978-01-01,The Boys from Brazil,12000000,19000000,19000000,7000000,1,0,1978,58.333333333333336
3388,89,2005-03-11,The Upside of Anger,12000000,18761993,28915761,16915761,3,10153768,2005,140.964675
3389,90,2006-03-03,Aquamarine,12000000,18597342,22978953,10978953,3,4381611,2006,91.491275
3390,91,2013-11-15,Nebraska,12000000,17654912,24761360,12761360,11,7106448,2013,106.34466666666667
3391,92,2004-01-09,My Baby's Daddy,12000000,17321573,17322212,5322212,1,639,2004,44.35176666666666
3392,93,2001-10-05,Max Keeble's Big Move,12000000,17292381,17292381,5292381,10,0,2001,44.103175
3393,94,2011-12-09,Young Adult,12000000,16311571,22750356,10750356,12,6438785,2011,89.5863
3394,95,2013-11-01,About Time,12000000,15323921,89309178,77309178,11,73985257,2013,644.24315
3395,96,2018-12-14,If Beale Street Could Talk,12000000,14915773,19859167,7859167,12,4943394,2018,65.49305833333334
3396,97,2017-07-14,Wish Upon,12000000,14301505,23477345,11477345,7,9175840,2017,95.64454166666667
3397,98,1997-08-06,Def Jam's How To Be a Player,12000000,14010363,14010363,2010363,8,0,1997,16.753025
3398,99,1998-10-30,Living Out Loud,12000000,12905901,12905901,905901,10,0,1998,7.549175
3399,100,2008-10-03,Rachel Getting Married,12000000,12796861,17475475,5475475,10,4678614,2008,45.62895833333334
3400,1,1981-03-20,The Postman Always Rings Twice,12000000,12200000,44200000,32200000,3,32000000,1981,268.3333333333333
3401,2,2003-12-12,Girl with a Pearl Earring,12000000,11634362,43274797,31274797,12,31640435,2003,260.62330833333334
3402,3,1982-02-10,Das Boot,12000000,11487676,84970337,72970337,2,73482661,1982,608.0861416666667
3403,4,2017-04-21,Unforgettable,12000000,11368012,16221211,4221211,4,4853199,2017,35.17675833333334
3404,5,2004-12-03,House of Flying Daggers,12000000,11050094,92863945,80863945,12,81813851,2004,673.8662083333334
3405,6,2002-03-22,Sorority Boys,12000000,10198766,12516222,516222,3,2317456,2002,4.30185
3406,7,2017-10-13,Marshall,12000000,10051659,10116816,-1883184,10,65157,2017,-15.6932
3407,8,2008-12-05,Cadillac Records,12000000,8195551,8942516,-3057484,12,746965,2008,-25.479033333333334
3408,9,2012-09-14,Arbitrage,12000000,7919574,35830713,23830713,9,27911139,2012,198.58927500000001
3409,10,1960-10-24,The Alamo,12000000,7900000,7900000,-4100000,10,0,1960,-34.166666666666664
3410,11,2000-05-12,Screwed,12000000,6982680,6982680,-5017320,5,0,2000,-41.811
3411,12,2006-10-20,Running With Scissors,12000000,6860000,8706701,-3293299,10,1846701,2006,-27.444158333333334
3412,13,1993-09-03,Fortress,12000000,6730578,46730578,34730578,9,40000000,1993,289.42148333333336
3413,14,2012-06-01,For Greater Glory: The True Story of Cristiada,12000000,5669081,10026255,-1973745,6,4357174,2012,-16.447875
3414,15,2006-11-17,For Your Consideration,12000000,5549923,5549923,-6450077,11,0,2006,-53.75064166666667
3415,16,1998-11-20,Celebrity,12000000,5078660,6200000,-5800000,11,1121340,1998,-48.333333333333336
3416,17,2003-06-20,From Justin to Kelly,12000000,4922166,4922166,-7077834,6,0,2003,-58.981950000000005
3417,18,1986-06-06,Invaders from Mars,12000000,4884663,4984663,-7015337,6,100000,1986,-58.46114166666667
3418,19,1996-03-22,Girl 6,12000000,4880941,4880941,-7119059,3,0,1996,-59.325491666666665
3419,20,2003-10-22,In the Cut,12000000,4717455,23693646,11693646,10,18976191,2003,97.44705
3420,21,2008-02-22,Charlie Bartlett,12000000,3950294,5295909,-6704091,2,1345615,2008,-55.867425000000004
3421,22,2009-02-13,Two Lovers,12000000,3149034,16349034,4349034,2,13200000,2009,36.24195
3422,23,2013-11-15,La grande bellezza,12000000,2883879,29549145,17549145,11,26665266,2013,146.242875
3423,24,2002-02-15,Last Orders,12000000,2326407,2326407,-9673593,2,0,2002,-80.613275
3424,25,2007-03-09,Gwoemul,12000000,2201923,92618117,80618117,3,90416194,2007,671.8176416666668
3425,26,1981-11-13,The Pursuit of D.B. Cooper,12000000,2104164,2104164,-9895836,11,0,1981,-82.4653
3426,27,1999-03-19,Ravenous,12000000,2062406,2062406,-9937594,3,0,1999,-82.81328333333333
3427,28,2002-06-14,The Dangerous Lives of Altar Boys,12000000,1779284,1779284,-10220716,6,0,2002,-85.17263333333334
3428,29,2013-03-01,Stoker,12000000,1703125,12034913,34913,3,10331788,2013,0.29094166666666665
3429,30,2008-03-07,Married Life,12000000,1506998,2975188,-9024812,3,1468190,2008,-75.20676666666667
3430,31,2005-08-05,2046,12000000,1442338,19287485,7287485,8,17845147,2005,60.729041666666674
3431,32,2011-03-11,Kill the Irishman,12000000,1188194,1188194,-10811806,3,0,2011,-90.09838333333333
3432,33,2005-09-30,Duma,12000000,870067,994790,-11005210,9,124723,2005,-91.71008333333333
3433,34,2012-04-20,Darling Companion,12000000,793352,1200346,-10799654,4,406994,2012,-89.99711666666667
3434,35,2010-06-04,Ondine,12000000,550472,557545,-11442455,6,7073,2010,-95.35379166666667
3435,36,2001-07-20,Brother,12000000,450594,450594,-11549406,7,0,2001,-96.24504999999999
3436,37,2002-10-04,Welcome to Collinwood,12000000,378650,4606284,-7393716,10,4227634,2002,-61.6143
3437,38,2008-04-18,Life Before Her Eyes,12000000,303439,7203439,-4796561,4,6900000,2008,-39.97134166666667
3438,39,1997-10-31,Critical Care,12000000,220175,220175,-11779825,10,0,1997,-98.16520833333333
3439,40,2007-09-28,Trade,12000000,214202,1513388,-10486612,9,1299186,2007,-87.38843333333334
3440,41,2006-01-06,Fateless,12000000,196857,196857,-11803143,1,0,2006,-98.359525
3441,42,2010-09-03,San qiang pai an jing qi,12000000,190946,310946,-11689054,9,120000,2010,-97.40878333333333
3442,43,1999-09-17,Breakfast of Champions,12000000,178287,178287,-11821713,9,0,1999,-98.514275
3443,44,2001-03-09,Company Man,12000000,146028,622273,-11377727,3,476245,2001,-94.81439166666667
3444,45,2009-11-07,Nanjing! Nanjing!,12000000,122558,20122558,8122558,11,20000000,2009,67.68798333333334
3445,46,2015-10-09,Trash,12000000,17484,6553186,-5446814,10,6535702,2015,-45.39011666666667
3446,47,2011-08-19,5 Days of War,12000000,17479,87793,-11912207,8,70314,2011,-99.26839166666667
3447,48,2015-11-11,10 Days in a Madhouse,12000000,14616,14616,-11985384,11,0,2015,-99.87819999999999
3448,49,2009-04-07,1612,12000000,0,5400624,-6599376,4,5400624,2009,-54.9948
3449,50,2015-12-31,San cheng ji,12000000,0,1950194,-10049806,12,1950194,2015,-83.74838333333334
3450,51,2011-12-31,Tu Xia Chuan Qi,12000000,0,1828400,-10171600,12,1828400,2011,-84.76333333333334
3451,52,2010-02-10,Triangle,12000000,0,1594955,-10405045,2,1594955,2010,-86.70870833333333
3452,53,2013-10-19,Supesu Batorushippu Yamato,12000000,0,0,-12000000,10,0,2013,-100.0
3453,54,2014-10-03,Drive Hard,12000000,0,0,-12000000,10,0,2014,-100.0
3454,55,2015-10-30,Dancin' It's On,12000000,0,0,-12000000,10,0,2015,-100.0
3455,56,2009-06-05,Home,12000000,0,0,-12000000,6,0,2009,-100.0
3456,57,2016-09-23,The Dressmaker,11900000,2022115,24041617,12141617,9,22019502,2016,102.03039495798319
3457,58,1999-12-10,Diamonds,11900000,81897,81897,-11818103,12,0,1999,-99.31178991596639
3458,59,1998-03-20,Madadayo,11900000,48856,48856,-11851144,3,0,1998,-99.58944537815127
3459,60,2015-11-20,Carol,11800000,12711491,42843521,31043521,11,30132030,2015,263.080686440678
3460,61,1989-04-21,Pet Sematary,11500000,57469179,57469179,45969179,4,0,1989,399.73199130434784
3461,62,2016-01-22,Dirty Grandpa,11500000,35593113,105078449,93578449,1,69485336,2016,813.7256434782608
3462,63,2009-11-27,The Cry of the Owl,11500000,0,0,-11500000,11,0,2009,-100.0
3463,64,2009-10-09,St. Trinianâs,11400000,15000,29830239,18430239,10,29815239,2009,161.66876315789474
3464,65,1977-05-25,Star Wars Ep. IV: A New Hope,11000000,460998007,786598007,775598007,5,325600000,1977,7050.890972727272
3465,66,1984-06-08,Gremlins,11000000,148168459,148199515,137199515,6,31056,1984,1247.2683181818181
3466,67,1965-12-22,Doctor Zhivago,11000000,111897830,112036323,101036323,12,138493,1965,918.5120272727273
3467,68,2010-12-10,The Fighter,11000000,93617009,129262388,118262388,12,35645379,2010,1075.112618181818
3468,69,2008-10-24,High School Musical 3: Senior Year,11000000,90559416,274392880,263392880,10,183833464,2008,2394.4807272727276
3469,70,1991-12-27,Fried Green Tomatoes,11000000,81204830,81204830,70204830,12,0,1991,638.2257272727272
3470,71,2006-09-22,Jackass: Number Two,11000000,72778712,85278712,74278712,9,12500000,2006,675.2610181818181
3471,72,1992-03-13,My Cousin Vinny,11000000,52929168,52929168,41929168,3,0,1992,381.1742545454545
3472,73,2014-08-22,If I Stay,11000000,50474843,78356170,67356170,8,27881327,2014,612.3288181818182
3473,74,1989-04-07,Major League,11000000,49793054,49793054,38793054,4,0,1989,352.6641272727273
3474,75,2003-04-04,Phone Booth,11000000,46566212,97837138,86837138,4,51270926,2003,789.4285272727273
3475,76,2002-01-25,A Walk to Remember,11000000,41227069,46060861,35060861,1,4833792,2002,318.7351
3476,77,1995-12-29,Dead Man Walking,11000000,39387284,83088295,72088295,12,43701011,1995,655.3481363636363
3477,78,1999-03-05,Cruel Intentions,11000000,38665260,76238901,65238901,3,37573641,1999,593.0809181818182
3478,79,2015-11-04,Brooklyn,11000000,38322743,62076141,51076141,11,23753398,2015,464.3285545454545
3479,80,2008-10-17,The Secret Life of Bees,11000000,37780486,39994347,28994347,10,2213861,2008,263.5849727272727
3480,81,2015-04-01,Woman in Gold,11000000,33307793,58586407,47586407,4,25278614,2015,432.60370000000006
3481,82,1981-06-12,History of the World: Part I,11000000,31672000,31672000,20672000,6,0,1981,187.9272727272727
3482,83,2017-12-08,"I, Tonya",11000000,30014534,53797409,42797409,12,23782875,2017,389.0673545454546
3483,84,2009-10-23,Saw VI,11000000,27693292,69752402,58752402,10,42059110,2009,534.1127454545455
3484,85,2001-10-12,Corky Romano,11000000,23978402,25116103,14116103,10,1137701,2001,128.3282090909091
3485,86,2019-02-14,Fighting With My Family,11000000,22958583,39049922,28049922,2,16091339,2019,254.99929090909092
3486,87,1992-08-07,Raising Cain,11000000,21171695,21171695,10171695,8,0,1992,92.46995454545454
3487,88,1978-04-13,F.I.S.T,11000000,20388920,20388920,9388920,4,0,1978,85.35381818181818
3488,89,1975-01-01,Barry Lyndon,11000000,20000000,20169934,9169934,1,169934,1975,83.36303636363637
3489,90,2013-01-11,Quartet,11000000,18388357,56178935,45178935,1,37790578,2013,410.7175909090909
3490,91,2001-11-21,Out Cold,11000000,13906394,14786394,3786394,11,880000,2001,34.421763636363636
3491,92,2000-10-13,The Ladies Man,11000000,13592872,13719474,2719474,10,126602,2000,24.722490909090908
3492,93,2001-03-30,Tomcats,11000000,13558739,13558739,2558739,3,0,2001,23.261263636363637
3493,94,2013-12-06,Inside Llewyn Davis,11000000,13248209,32943247,21943247,12,19695038,2013,199.48406363636363
3494,95,2002-04-12,Frailty,11000000,13110448,19947280,8947280,4,6836832,2002,81.3389090909091
3495,96,1993-02-19,Army of Darkness,11000000,11502976,21502976,10502976,2,10000000,1993,95.4816
3496,97,2004-11-12,Kinsey,11000000,10214647,17443529,6443529,11,7228882,2004,58.57753636363636
3497,98,2013-05-10,Peeples,11000000,9177065,9307166,-1692834,5,130101,2013,-15.3894
3498,99,1993-12-25,What's Eating Gilbert Grape,11000000,9170214,9170214,-1829786,12,0,1993,-16.63441818181818
3499,100,2016-07-06,Sultan,11000000,5599781,72989781,61989781,7,67390000,2016,563.5434636363636
3500,1,2002-02-01,Slackers,11000000,4814244,5942218,-5057782,2,1127974,2002,-45.97983636363636
3501,2,2003-09-26,The Gospel of John,11000000,4068087,4234355,-6765645,9,166268,2003,-61.505863636363635
3502,3,2004-10-10,Vera Drake,11000000,3753806,13353855,2353855,10,9600049,2004,21.39868181818182
3503,4,2003-01-31,The Guru,11000000,3051221,24150550,13150550,1,21099329,2003,119.55045454545454
3504,5,1995-12-14,Othello,11000000,2844379,2844379,-8155621,12,0,1995,-74.14200909090908
3505,6,1995-05-12,The Perez Family,11000000,2794056,2794056,-8205944,5,0,1995,-74.5994909090909
3506,7,1970-01-01,The Molly Maguires,11000000,2200000,2200000,-8800000,1,0,1970,-80.0
3507,8,1991-01-01,Return to the Blue Lagoon,11000000,2000000,2000000,-9000000,1,0,1991,-81.81818181818183
3508,9,2007-09-07,Romance and Cigarettes,11000000,551002,3231251,-7768749,9,2680249,2007,-70.62499090909091
3509,10,2006-11-10,Copying Beethoven,11000000,355968,6586324,-4413676,11,6230356,2006,-40.12432727272727
3510,11,2011-08-26,Brighton Rock,11000000,229653,229653,-10770347,8,0,2011,-97.91224545454546
3511,12,2012-11-16,Le prÃ©nom,11000000,61611,25307405,14307405,11,25245794,2012,130.0673181818182
3512,13,2015-05-08,La famille BÃ©lier,11000000,0,82438670,71438670,5,82438670,2015,649.4424545454546
3513,14,2012-05-04,LOL,11000000,0,10431506,-568494,5,10431506,2012,-5.168127272727273
3514,15,2016-02-05,Misconduct,11000000,0,2352511,-8647489,2,2352511,2016,-78.61353636363636
3515,16,2019-12-31,Eli,11000000,0,0,-11000000,12,0,2019,-100.0
3516,17,2008-10-24,Saw V,10800000,56746769,118209778,107409778,10,61463009,2008,994.5349814814815
3517,18,2012-05-25,Les Intouchables,10800000,13182281,484873045,474073045,5,471690764,2012,4389.5652314814815
3518,19,2007-04-27,Jindabyne,10800000,399879,2862544,-7937456,4,2462665,2007,-73.49496296296296
3519,20,2006-08-11,Kabhi Alvida Naa Kehna,10750000,3275443,32575443,21825443,8,29300000,2006,203.02737674418606
3520,21,1979-05-25,Alien,10700000,80930630,203628947,192928947,5,122698317,1979,1803.0742710280374
3521,22,1982-06-04,Poltergeist,10700000,74706019,121706019,111006019,6,47000000,1982,1037.439429906542
3522,23,1999-06-18,An Ideal Husband,10700000,18542974,31341183,20641183,6,12798209,1999,192.90825233644858
3523,24,2004-12-25,Darkness,10600000,22163442,34409206,23809206,12,12245764,2004,224.61515094339623
3524,25,2013-12-06,The Last Days on Mars,10600000,24084,261364,-10338636,12,237280,2013,-97.53430188679245
3525,26,1982-06-11,ET: The Extra-Terrestrial,10500000,435110554,792965326,782465326,6,357854772,1982,7452.050723809523
3526,27,1968-04-02,2001: A Space Odyssey,10500000,59936321,71928046,61428046,4,11991725,1968,585.0290095238095
3527,28,2007-04-20,In the Land of Women,10500000,11052958,14140402,3640402,4,3087444,2007,34.67049523809524
3528,29,1994-12-31,There Goes My Baby,10500000,125169,125169,-10374831,12,0,1994,-98.80791428571428
3529,30,2004-02-20,The Blue Butterfly,10400000,1610194,1610194,-8789806,2,0,2004,-84.51736538461539
3530,31,2001-11-02,Le Fabuleux destin d'AmÃ©lie Poulain,10350000,33201661,174201661,163851661,11,141000000,2001,1583.1078357487922
3531,32,2019-01-04,PMC: deo beong-keo,10300000,0,12478635,2178635,1,12478635,2019,21.151796116504855
3532,33,1983-02-18,Lovesick,10100000,10143618,10143618,43618,2,0,1983,0.43186138613861386
3533,34,2010-04-30,Housefull,10100000,1183658,18726300,8626300,4,17542642,2010,85.4089108910891
3534,35,2007-08-24,September Dawn,10100000,1066555,1066555,-9033445,8,0,2007,-89.4400495049505
3535,36,2018-10-19,Halloween,10000000,159342015,254900667,244900667,10,95558652,2018,2449.0066699999998
3536,37,1997-12-05,Good Will Hunting,10000000,138433435,225925989,215925989,12,87492554,1997,2159.25989
3537,38,2004-10-22,The Grudge,10000000,110359362,187281115,177281115,10,76921753,2004,1772.81115
3538,39,2016-08-26,Donât Breathe,10000000,89217875,158973685,148973685,8,69755810,2016,1489.73685
3539,40,1981-06-26,Stripes,10000000,85300000,85300000,75300000,6,0,1981,753.0
3540,41,2006-10-27,Saw III,10000000,80238724,163876815,153876815,10,83638091,2006,1538.7681499999999
3541,42,2016-07-01,The Purge: Election Year,10000000,79042440,118514727,108514727,7,39472287,2016,1085.14727
3542,43,2018-05-18,Book Club,10000000,68566296,91113683,81113683,5,22547387,2018,811.13683
3543,44,2000-08-25,Bring it On,10000000,68353550,90453550,80453550,8,22100000,2000,804.5355000000001
3544,45,2018-01-05,Insidious: The Last Key,10000000,67745330,167885588,157885588,1,100140258,2018,1578.85588
3545,46,1999-01-29,She's All That,10000000,63465522,63465522,53465522,1,0,1999,534.65522
3546,47,2007-10-26,Saw IV,10000000,63300095,135759694,125759694,10,72459599,2007,1257.59694
3547,48,2006-02-24,Madea's Family Reunion,10000000,63257940,63320521,53320521,2,62581,2006,533.2052100000001
3548,49,2005-01-07,White Noise,10000000,56094360,92094360,82094360,1,36000000,2005,820.9436000000001
3549,50,1986-10-17,The Color of Money,10000000,52293000,52293000,42293000,10,0,1986,422.93
3550,51,2015-06-05,Insidious Chapter 3,10000000,52218558,120453155,110453155,6,68234597,2015,1104.53155
3551,52,1992-10-02,The Mighty Ducks,10000000,50752337,50752337,40752337,10,0,1992,407.52337
3552,53,2017-11-03,Lady Bird,10000000,48958273,78610769,68610769,11,29652496,2017,686.1076899999999
3553,54,2009-11-06,Precious (Based on the Novel Push by Sapphire),10000000,47566524,68722848,58722848,11,21156324,2009,587.22848
3554,55,2012-05-04,The Best Exotic Marigold Hotel,10000000,46383639,134639780,124639780,5,88256141,2012,1246.3978
3555,56,2018-06-08,Hereditary,10000000,44069456,70133905,60133905,6,26064449,2018,601.33905
3556,57,2018-03-16,"Love, Simon",10000000,40826341,65520633,55520633,3,24694292,2018,555.20633
3557,58,1989-02-17,Bill & Ted's Excellent Adventure,10000000,40485039,40485039,30485039,2,0,1989,304.85039
3558,59,1962-10-04,The Longest Day,10000000,39100000,50100000,40100000,10,11000000,1962,401.0
3559,60,1996-02-16,Happy Gilmore,10000000,38623460,41004412,31004412,2,2380952,1996,310.04412
3560,61,2017-10-27,Jigsaw,10000000,38052832,102445196,92445196,10,64392364,2017,924.45196
3561,62,2001-08-31,Jeepers Creepers,10000000,37904175,58939035,48939035,8,21034860,2001,489.39035
3562,63,1985-06-28,St. Elmoâs Fire,10000000,37800000,37800000,27800000,6,0,1985,278.0
3563,64,1968-12-11,Oliver!,10000000,37402877,37402877,27402877,12,0,1968,274.02877
3564,65,2001-02-16,Recess: School's Out,10000000,36696761,44451470,34451470,2,7754709,2001,344.5147
3565,66,1985-07-10,Mad Max Beyond Thunderdome,10000000,36230219,36230219,26230219,7,0,1985,262.30219
3566,67,1977-11-03,Peteâs Dragon,10000000,36000000,36000000,26000000,11,0,1977,260.0
3567,68,2016-01-22,The Boy,10000000,35819556,68220952,58220952,1,32401396,2016,582.20952
3568,69,1985-10-04,Commando,10000000,35073978,35073978,25073978,10,0,1985,250.73978000000002
3569,70,2017-05-19,"Everything, Everything",10000000,34121140,61603136,51603136,5,27481996,2017,516.0313600000001
3570,71,2010-09-17,Devil,10000000,33679655,63354114,53354114,9,29674459,2010,533.54114
3571,72,2002-11-22,Friday After Next,10000000,33253609,33526835,23526835,11,273226,2002,235.26835
3572,73,2015-03-06,The Second Best Exotic Marigold Hotel,10000000,33078266,90384306,80384306,3,57306040,2015,803.84306
3573,74,1985-03-22,The Last Dragon,10000000,33000000,33000000,23000000,3,0,1985,229.99999999999997
3574,75,2017-04-28,How to Be a Latin Lover,10000000,32149404,62556228,52556228,4,30406824,2017,525.56228
3575,76,1992-03-06,The Lawnmower Man,10000000,32100816,32100816,22100816,3,0,1992,221.00816
3576,77,2008-10-03,Nick and Norah's Infinite Playlist,10000000,31487293,33886017,23886017,10,2398724,2008,238.86017
3577,78,2003-12-19,Calendar Girls,10000000,31011616,93074616,83074616,12,62063000,2003,830.74616
3578,79,1999-11-12,Dogma,10000000,30651422,43948865,33948865,11,13297443,1999,339.48865
3579,80,2018-08-10,Slender Man,10000000,30564825,51723644,41723644,8,21158819,2018,417.23644
3580,81,2002-09-20,The Banger Sisters,10000000,30306281,38067218,28067218,9,7760937,2002,280.67218
3581,82,2000-12-08,Snatch,10000000,30093107,83593107,73593107,12,53500000,2000,735.93107
3582,83,1989-05-19,Road House,10000000,30050028,30050028,20050028,5,0,1989,200.50028000000003
3583,84,2018-07-27,Teen Titans Go! To The Movies,10000000,29790236,51620593,41620593,7,21830357,2018,416.20593
3584,85,2016-09-09,When the Bough Breaks,10000000,29747603,30768449,20768449,9,1020846,2016,207.68449
3585,86,1983-06-24,Twilight Zone: The Movie,10000000,29500000,29500000,19500000,6,0,1983,195.0
3586,87,1994-11-23,A Low Down Dirty Shame,10000000,29317886,29317886,19317886,11,0,1994,193.17886
3587,88,2013-08-30,One Direction: This is Us,10000000,28873374,68541786,58541786,8,39668412,2013,585.41786
3588,89,2002-09-06,Swimfan,10000000,28564995,34084228,24084228,9,5519233,2002,240.84228
3589,90,2006-10-06,Employee of the Month,10000000,28444855,38364855,28364855,10,9920000,2006,283.64855
3590,91,2015-08-21,Sinister 2,10000000,27740955,54104225,44104225,8,26363270,2015,441.04225
3591,92,2016-01-08,The Forest,10000000,26594261,40749230,30749230,1,14154969,2016,307.4923
3592,93,2009-11-06,The Fourth Kind,10000000,26218170,49486874,39486874,11,23268704,2009,394.86874
3593,94,1983-03-25,The Outsiders,10000000,25697647,25697647,15697647,3,0,1983,156.97646999999998
3594,95,1998-06-12,Can't Hardly Wait,10000000,25358996,25358996,15358996,6,0,1998,153.58996
3595,96,2012-08-17,Sparkle,10000000,24397469,24660323,14660323,8,262854,2012,146.60323
3596,97,2016-10-14,Kevin Hart: What Now?,10000000,23591043,23591043,13591043,10,0,2016,135.91043
3597,98,2013-04-26,Mud,10000000,21590086,31556959,21556959,4,9966873,2013,215.56959
3598,99,2010-11-12,Skyline,10000000,21416355,68264973,58264973,11,46848618,2010,582.64973
3599,100,2017-12-01,The Disaster Artist,10000000,21120616,28717667,18717667,12,7597051,2017,187.17667
3600,1,2016-09-16,Blair Witch,10000000,20777061,38985577,28985577,9,18208516,2016,289.85577
3601,2,1983-10-21,The Dead Zone,10000000,20766000,20766000,10766000,10,0,1983,107.66
3602,3,2001-02-02,Valentine,10000000,20384136,20384136,10384136,2,0,2001,103.84136
3603,4,2006-06-09,A Prairie Home Companion,10000000,20342852,26716191,16716191,6,6373339,2006,167.16191
3604,5,2007-02-23,Reno 911!: Miami,10000000,20342161,21851362,11851362,2,1509201,2007,118.51362
3605,6,1998-07-24,Jane Austen's Mafia,10000000,19843795,30143795,20143795,7,10300000,1998,201.43795
3606,7,2015-10-23,Paranormal Activity: The Ghost Dimension,10000000,18297124,77959374,67959374,10,59662250,2015,679.59374
3607,8,1994-02-25,Sugar Hill,10000000,18272447,18423914,8423914,2,151467,1994,84.23914
3608,9,2008-06-20,Kit Kittredge: An American Girl,10000000,17657973,17657973,7657973,6,0,2008,76.57973
3609,10,1985-09-27,Invasion U.S.A.,10000000,17536256,17536256,7536256,9,0,1985,75.36256
3610,11,2005-09-23,Roll Bounce,10000000,17380866,17433072,7433072,9,52206,2005,74.33072
3611,12,1998-12-11,Rushmore,10000000,17105219,19080435,9080435,12,1975216,1998,90.80435
3612,13,1990-01-19,Tremors,10000000,16667084,16667084,6667084,1,0,1990,66.67084
3613,14,2005-06-17,The Perfect Man,10000000,16535005,19535005,9535005,6,3000000,2005,95.35005
3614,15,1990-08-03,Mo' Better Blues,10000000,16153000,16153000,6153000,8,0,1990,61.529999999999994
3615,16,2002-01-25,Kung Pow: Enter the Fist,10000000,16033556,17033556,7033556,1,1000000,2002,70.33556
3616,17,2016-10-07,The Birth of a Nation,10000000,15861566,16891011,6891011,10,1029445,2016,68.91011
3617,18,2003-05-30,Wrong Turn,10000000,15417771,28649556,18649556,5,13231785,2003,186.49556
3618,19,1980-05-16,The Long Riders,10000000,15198912,15198912,5198912,5,0,1980,51.98912
3619,20,1999-03-12,The Corruptor,10000000,15164492,15164492,5164492,3,0,1999,51.644920000000006
3620,21,2009-08-14,"The Goods: Live Hard, Sell Hard",10000000,15122676,15297318,5297318,8,174642,2009,52.97318
3621,22,2011-11-23,My Week with Marilyn,10000000,14597405,34240572,24240572,11,19643167,2011,242.40572
3622,23,2014-12-25,Big Eyes,10000000,14482031,27317872,17317872,12,12835841,2014,173.17872
3623,24,2005-08-05,Broken Flowers,10000000,13744960,40744960,30744960,8,27000000,2005,307.4496
3624,25,2002-06-28,Hey Arnold! The Movie,10000000,13684949,13684949,3684949,6,0,2002,36.84949
3625,26,2005-12-30,The Matador,10000000,12589255,17300838,7300838,12,4711583,2005,73.00837999999999
3626,27,1997-03-14,Love Jones,10000000,12554569,12554569,2554569,3,0,1997,25.54569
3627,28,2000-12-19,The Gift,10000000,12008642,44567606,34567606,12,32558964,2000,345.67606
3628,29,2006-01-20,End of the Spear,10000000,11748661,11924041,1924041,1,175380,2006,19.24041
3629,30,2001-03-09,Get Over It,10000000,11560259,19860259,9860259,3,8300000,2001,98.60259
3630,31,2000-10-20,The Legend of Drunken Master,10000000,11546543,11546543,1546543,10,0,2000,15.46543
3631,32,1999-02-19,Office Space,10000000,10827813,12179708,2179708,2,1351895,1999,21.797079999999998
3632,33,1999-07-23,Drop Dead Gorgeous,10000000,10571408,10571408,571408,7,0,1999,5.71408
3633,34,2019-04-05,The Best of Enemies,10000000,10205616,10205616,205616,4,0,2019,2.0561599999999998
3634,35,1998-04-03,The Spanish Prisoner,10000000,10162034,13835130,3835130,4,3673096,1998,38.3513
3635,36,1999-06-11,Le Violon rouge,10000000,10019109,10019109,19109,6,0,1999,0.19109
3636,37,1998-11-25,Very Bad Things,10000000,9949470,21094974,11094974,11,11145504,1998,110.94973999999999
3637,38,2004-07-09,Sleepover,10000000,9408183,9408183,-591817,7,0,2004,-5.91817
3638,39,2013-01-25,Movie 43,10000000,8840453,31164747,21164747,1,22324294,2013,211.64747
3639,40,2018-10-19,Can You Ever Forgive Me?,10000000,8803865,11752387,1752387,10,2948522,2018,17.52387
3640,41,1984-10-26,Body Double,10000000,8801940,8801940,-1198060,10,0,1984,-11.980599999999999
3641,42,2010-05-21,MacGruber,10000000,8525600,8629895,-1370105,5,104295,2010,-13.70105
3642,43,2003-07-18,Dirty Pretty Things,10000000,8112414,14156753,4156753,7,6044339,2003,41.567530000000005
3643,44,2014-03-14,Bad Words,10000000,7779614,7843145,-2156855,3,63531,2014,-21.568550000000002
3644,45,2015-03-27,While We're Young,10000000,7582065,17503828,7503828,3,9921763,2015,75.03828
3645,46,2008-02-01,Over Her Dead Body,10000000,7570127,21596074,11596074,2,14025947,2008,115.96074
3646,47,2001-10-24,Bones,10000000,7316658,8378853,-1621147,10,1062195,2001,-16.21147
3647,48,2012-06-22,Seeking a Friend for the End of the World,10000000,7078738,11766959,1766959,6,4688221,2012,17.66959
3648,49,2006-12-01,Turistas,10000000,7027762,14321070,4321070,12,7293308,2006,43.2107
3649,50,2016-11-11,Shut In,10000000,6900335,11360665,1360665,11,4460330,2016,13.60665
3650,51,2011-02-11,Cedar Rapids,10000000,6861102,7862131,-2137869,2,1001029,2011,-21.37869
3651,52,2012-11-30,The Collection,10000000,6810754,8890094,-1109906,11,2079340,2012,-11.09906
3652,53,1998-10-30,American History X,10000000,6719864,6719864,-3280136,10,0,1998,-32.80136
3653,54,2004-01-16,Teacher's Pet: The Movie,10000000,6491969,6491969,-3508031,1,0,2004,-35.08031
3654,55,1999-10-15,The Straight Story,10000000,6197866,6197866,-3802134,10,0,1999,-38.021339999999995
3655,56,2002-05-03,Deuces Wild,10000000,6044618,6244618,-3755382,5,200000,2002,-37.55382
3656,57,2008-03-28,"Run, Fatboy, Run",10000000,6003262,33512260,23512260,3,27508998,2008,235.1226
3657,58,1981-12-18,Heartbeeps,10000000,6000000,6000000,-4000000,12,0,1981,-40.0
3658,59,2015-03-20,Danny Collins,10000000,5637066,8465845,-1534155,3,2828779,2015,-15.341550000000002
3659,60,2007-07-04,Rescue Dawn,10000000,5490423,7037886,-2962114,7,1547463,2007,-29.62114
3660,61,2000-04-05,Black and White,10000000,5241315,5241315,-4758685,4,0,2000,-47.586850000000005
3661,62,2010-06-18,Io sono lâamore,10000000,5005465,15121528,5121528,6,10116063,2010,51.21527999999999
3662,63,2001-10-26,On the Line,10000000,4365455,4690802,-5309198,10,325347,2001,-53.09198000000001
3663,64,2018-06-15,Gotti,10000000,4286367,6089100,-3910900,6,1802733,2018,-39.109
3664,65,2012-03-16,"Jeff, Who Lives at Home",10000000,4269426,4708127,-5291873,3,438701,2012,-52.918730000000004
3665,66,2016-09-30,Denial,10000000,4073448,9263940,-736060,9,5190492,2016,-7.360600000000001
3666,67,2016-04-29,The Man Who Knew Infinity,10000000,3877922,12382122,2382122,4,8504200,2016,23.82122
3667,68,2016-10-14,Max Steel,10000000,3818664,4563080,-5436920,10,744416,2016,-54.36919999999999
3668,69,2016-03-30,Everybody Wants Some,10000000,3400278,5437126,-4562874,3,2036848,2016,-45.62874
3669,70,1996-10-04,Crash,10000000,3357324,3357324,-6642676,10,0,1996,-66.42676
3670,71,2012-10-12,Atlas Shrugged: Part II,10000000,3336053,3336053,-6663947,10,0,2012,-66.63947
3671,72,1994-02-04,Romeo Is Bleeding,10000000,3275585,3275585,-6724415,2,0,1994,-67.24415
3672,73,1999-10-08,The Limey,10000000,3193102,6030047,-3969953,10,2836945,1999,-39.69953
3673,74,2014-11-14,Rosewater,10000000,3128941,3185717,-6814283,11,56776,2014,-68.14283
3674,75,2000-12-22,The House of Mirth,10000000,3041803,5149131,-4850869,12,2107328,2000,-48.50869
3675,76,1987-05-01,Malone,10000000,3000000,3000000,-7000000,5,0,1987,-70.0
3676,77,2006-06-02,Peaceful Warrior,10000000,2893666,3260179,-6739821,6,366513,2006,-67.39821
3677,78,2011-09-09,Bucky Larson: Born to Be a Star,10000000,2529395,2529395,-7470605,9,0,2011,-74.70605
3678,79,2000-10-06,Bamboozled,10000000,2185266,2373937,-7626063,10,188671,2000,-76.26062999999999
3679,80,1981-02-11,Sphinx,10000000,2000000,11400000,1400000,2,9400000,1981,14.000000000000002
3680,81,2013-05-03,The Iceman,10000000,1930282,3623609,-6376391,5,1693327,2013,-63.76391
3681,82,2015-06-05,Testament of Youth,10000000,1822250,6646669,-3353331,6,4824419,2015,-33.53331
3682,83,2017-04-21,Free Fire,10000000,1799322,3793739,-6206261,4,1994417,2017,-62.06260999999999
3683,84,2011-06-24,A Better Life,10000000,1759252,1884251,-8115749,6,124999,2011,-81.15749
3684,85,2003-02-28,Spider,10000000,1641788,1641788,-8358212,2,0,2003,-83.58212
3685,86,2000-02-04,Gun Shy,10000000,1638202,1638202,-8361798,2,0,2000,-83.61798
3686,87,2002-12-27,Nicholas Nickleby,10000000,1562800,1562800,-8437200,12,0,2002,-84.372
3687,88,2010-04-16,The Joneses,10000000,1475746,3541565,-6458435,4,2065819,2010,-64.58435
3688,89,2006-06-23,Krrish,10000000,1430721,32430721,22430721,6,31000000,2006,224.30721
3689,90,2012-07-27,Killer Joe,10000000,1291645,4659110,-5340890,7,3367465,2012,-53.4089
3690,91,2017-06-02,Churchill,10000000,1279681,7582196,-2417804,6,6302515,2017,-24.17804
3691,92,2000-08-11,Cecil B. Demented,10000000,1276984,1953882,-8046118,8,676898,2000,-80.46118
3692,93,2014-03-21,50 to 1,10000000,1069454,1069454,-8930546,3,0,2014,-89.30546
3693,94,2003-05-02,Owning Mahowny,10000000,1011054,1011054,-8988946,5,0,2003,-89.88946
3694,95,2007-10-19,The Ten Commandments,10000000,952820,1051907,-8948093,10,99087,2007,-89.48093
3695,96,2007-09-07,The Brothers Solomon,10000000,900926,900926,-9099074,9,0,2007,-90.99074
3696,97,2008-04-04,My Blueberry Nights,10000000,866778,22198996,12198996,4,21332218,2008,121.98996
3697,98,1999-08-06,Illuminata,10000000,836641,836641,-9163359,8,0,1999,-91.63359
3698,99,2012-01-20,Coriolanus,10000000,749641,2179623,-7820377,1,1429982,2012,-78.20376999999999
3699,100,2013-10-04,Parkland,10000000,641439,1616353,-8383647,10,974914,2013,-83.83646999999999
3700,1,2002-10-11,Swept Away,10000000,598645,598645,-9401355,10,0,2002,-94.01355
3701,2,2008-05-23,"War, Inc.",10000000,580862,1299855,-8700145,5,718993,2008,-87.00145
3702,3,2004-04-02,Shaolin Soccer,10000000,488872,42776032,32776032,4,42287160,2004,327.76032000000004
3703,4,2004-08-27,The Brown Bunny,10000000,366301,630427,-9369573,8,264126,2004,-93.69573
3704,5,2007-09-14,King of California,10000000,268461,1165102,-8834898,9,896641,2007,-88.34898
3705,6,1997-10-24,Rien ne va plus,10000000,245359,5045359,-4954641,10,4800000,1997,-49.54641
3706,7,1998-08-14,La femme de chambre du Titanic,10000000,244465,244465,-9755535,8,0,1998,-97.55534999999999
3707,8,2004-12-17,Imaginary Heroes,10000000,228524,290875,-9709125,12,62351,2004,-97.09125
3708,9,2001-10-26,High Heels and Low Lifes,10000000,226792,226792,-9773208,10,0,2001,-97.73208
3709,10,2009-08-21,World's Greatest Dad,10000000,221805,295750,-9704250,8,73945,2009,-97.0425
3710,11,2013-05-03,"Cinco de Mayo, La Batalla",10000000,173472,173472,-9826528,5,0,2013,-98.26528
3711,12,2010-10-29,Welcome to the Rileys,10000000,152857,355919,-9644081,10,203062,2010,-96.44081
3712,13,2016-09-09,Kicks,10000000,150191,150191,-9849809,9,0,2016,-98.49809
3713,14,2009-10-09,Free Style,10000000,141108,721108,-9278892,10,580000,2009,-92.78891999999999
3714,15,2012-06-01,High School,10000000,139034,248133,-9751867,6,109099,2012,-97.51867
3715,16,2007-05-18,Severance,10000000,137221,5950002,-4049998,5,5812781,2007,-40.49998
3716,17,2006-07-14,Edmond,10000000,131719,241719,-9758281,7,110000,2006,-97.58281
3717,18,2010-04-23,Joheunnom nabbeunnom isanghannom,10000000,128486,42226657,32226657,4,42098171,2010,322.26657
3718,19,1994-08-26,Police Academy 7: Mission to Moscow,10000000,126247,126247,-9873753,8,0,1994,-98.73752999999999
3719,20,2010-02-19,Blood Done Sign My Name,10000000,109383,109383,-9890617,2,0,2010,-98.90617
3720,21,2010-02-19,The Good Guy,10000000,100688,106460,-9893540,2,5772,2010,-98.9354
3721,22,2009-10-23,Motherhood,10000000,93388,723388,-9276612,10,630000,2009,-92.76612
3722,23,2004-10-15,Eulogy,10000000,70527,70527,-9929473,10,0,2004,-99.29473
3723,24,2014-11-07,Elsa & Fred,10000000,67657,197901,-9802099,11,130244,2014,-98.02099
3724,25,1998-02-27,An Alan Smithee Film: Burn Hollywood Burn,10000000,45779,45779,-9954221,2,0,1998,-99.54221
3725,26,2009-08-28,The Open Road,10000000,19716,19716,-9980284,8,0,2009,-99.80284
3726,27,2015-07-10,Strangerland,10000000,17472,161097,-9838903,7,143625,2015,-98.38903
3727,28,2015-03-13,Hross i oss,10000000,11894,11894,-9988106,3,0,2015,-99.88106
3728,29,2009-10-16,Janky Promoters,10000000,9069,9069,-9990931,10,0,2009,-99.90930999999999
3729,30,2007-12-21,Blonde Ambition,10000000,6422,1537479,-8462521,12,1531057,2007,-84.62521
3730,31,2010-08-06,The Oxford Murders,10000000,4803,17704131,7704131,8,17699328,2010,77.04131
3731,32,2014-12-26,Barbecue,10000000,388,247565,-9752435,12,247177,2014,-97.52435
3732,33,2010-12-31,The Reef,10000000,0,15037867,5037867,12,15037867,2010,50.37867
3733,34,2008-01-08,White Noise 2: The Light,10000000,0,8243567,-1756433,1,8243567,2008,-17.56433
3734,35,2015-07-21,American Heist,10000000,0,2341218,-7658782,7,2341218,2015,-76.58782
3735,36,2010-10-08,It's a Wonderful Afterlife,10000000,0,1642939,-8357061,10,1642939,2010,-83.57061
3736,37,2011-06-21,You Got Served: Beat The World,10000000,0,1230542,-8769458,6,1230542,2011,-87.69458
3737,38,2009-08-21,Fifty Dead Men Walking,10000000,0,997921,-9002079,8,997921,2009,-90.02078999999999
3738,39,2014-09-26,Plastic,10000000,0,575371,-9424629,9,575371,2014,-94.24629
3739,40,2015-03-10,Jungle Shuffle,10000000,0,360898,-9639102,3,360898,2015,-96.39102000000001
3740,41,2009-09-22,Adam Resurrected,10000000,0,90909,-9909091,9,90909,2009,-99.09091
3741,42,2009-05-26,The Devil's Tomb,10000000,0,0,-10000000,5,0,2009,-100.0
3742,43,2009-12-31,Good Intentions,10000000,0,0,-10000000,12,0,2009,-100.0
3743,44,2007-02-02,Partition,10000000,0,0,-10000000,2,0,2007,-100.0
3744,45,2012-04-13,Detention,10000000,0,0,-10000000,4,0,2012,-100.0
3745,46,2014-02-07,Nurse 3D,10000000,0,0,-10000000,2,0,2014,-100.0
3746,47,2015-05-19,Into the Grizzly Maze,10000000,0,0,-10000000,5,0,2015,-100.0
3747,48,2017-09-22,Friend Request,9900000,3759078,11310835,1410835,9,7551757,2017,14.250858585858586
3748,49,2010-04-30,Gunless,9900000,458054,458054,-9441946,4,0,2010,-95.37319191919192
3749,50,2009-04-03,Adventureland,9800000,16044025,17553055,7753055,4,1509030,2009,79.11280612244897
3750,51,2012-12-19,Amour,9700000,6738954,36787044,27087044,12,30048090,2012,279.24787628865977
3751,52,2006-04-28,The Lost City,9600000,2484186,5256839,-4343161,4,2772653,2006,-45.24126041666667
3752,53,2000-01-12,Next Friday,9500000,57176582,59675307,50175307,1,2498725,2000,528.1611263157895
3753,54,1967-06-13,You Only Live Twice,9500000,43100000,111600000,102100000,6,68500000,1967,1074.7368421052631
3754,55,1988-06-10,Poltergeist III,9500000,14114000,14114000,4614000,6,0,1988,48.56842105263158
3755,56,2016-12-21,Dangal,9500000,12391761,294654618,285154618,12,282262857,2016,3001.627557894737
3756,57,2010-03-19,The Runaways,9500000,3573673,5278632,-4221368,3,1704959,2010,-44.43545263157895
3757,58,2009-10-30,Gentlemen Broncos,9500000,115155,119955,-9380045,10,4800,2009,-98.73731578947368
3758,59,2013-12-31,Re-Kill,9500000,0,0,-9500000,12,0,2013,-100.0
3759,60,1963-11-07,It's a Mad Mad Mad Mad World,9400000,46300000,60000000,50600000,11,13700000,1963,538.2978723404256
3760,61,2006-11-03,Volver,9400000,12899867,87226613,77826613,11,74326746,2006,827.9426914893618
3761,62,2011-11-11,Melancholia,9400000,3030848,21817298,12417298,11,18786450,2011,132.09891489361704
3762,63,1981-08-07,Heavy Metal,9300000,19571091,19571091,10271091,8,0,1981,110.44183870967741
3763,64,2012-11-13,Jab Tak Hai Jaan,9200000,3047539,5806666,-3393334,11,2759127,2012,-36.8840652173913
3764,65,1995-12-29,Richard III,9200000,2684904,4199334,-5000666,12,1514430,1995,-54.35506521739131
3765,66,2010-05-21,Kites,9200000,1685269,17155193,7955193,5,15469924,2010,86.46948913043478
3766,67,2011-12-31,Red Dog,9100000,0,20927794,11827794,12,20927794,2011,129.97575824175826
3767,68,2010-12-31,Mine Vaganti,9100000,0,18872126,9772126,12,18872126,2010,107.38600000000001
3768,69,2003-10-17,The Texas Chainsaw Massacre,9000000,80571655,107967319,98967319,10,27395664,2003,1099.636877777778
3769,70,1971-01-01,Fiddler on the Roof,9000000,80500000,80500000,71500000,1,0,1971,794.4444444444445
3770,71,2014-07-18,The Purge: Anarchy,9000000,71562550,111534881,102534881,7,39972331,2014,1139.2764555555555
3771,72,1965-12-29,Thunderball,9000000,63600000,141200000,132200000,12,77600000,1965,1468.888888888889
3772,73,2008-05-30,The Strangers,9000000,52597610,83051676,74051676,5,30454066,2008,822.7964
3773,74,1996-11-06,Set It Off,9000000,36049108,36049108,27049108,11,0,1996,300.54564444444446
3774,75,2016-10-21,Ouija: Origin of Evil,9000000,35144505,81831866,72831866,10,46687361,2016,809.2429555555557
3775,76,1999-10-22,The Best Man,9000000,34102780,34572780,25572780,10,470000,1999,284.142
3776,77,1988-11-09,Child's Play,9000000,33244684,44196684,35196684,11,10952000,1988,391.0742666666667
3777,78,2019-02-13,Happy Death Day 2U,9000000,28051045,64179495,55179495,2,36128450,2019,613.1055
3778,79,2007-06-22,Sicko,9000000,24538513,36535837,27535837,6,11997324,2007,305.95374444444445
3779,80,2015-01-30,Black or White,9000000,21571189,21971021,12971021,1,399832,2015,144.12245555555558
3780,81,2000-01-21,Down to You,9000000,20035310,20035310,11035310,1,0,2000,122.61455555555555
3781,82,2004-07-30,Harold & Kumar Go to White Castle,9000000,18225165,18225165,9225165,7,0,2004,102.50183333333334
3782,83,2000-10-13,The Contender,9000000,17804273,17804273,8804273,10,0,2000,97.82525555555556
3783,84,2000-02-18,Boiler Room,9000000,16963963,28773637,19773637,2,11809674,2000,219.70707777777778
3784,85,2006-12-05,Black Christmas,9000000,16235738,16235738,7235738,12,0,2006,80.39708888888889
3785,86,2016-11-18,The Edge of Seventeen,9000000,14431633,19096003,10096003,11,4664370,2016,112.17781111111111
3786,87,2016-12-02,Jackie,9000000,13960394,36588512,27588512,12,22628118,2016,306.53902222222223
3787,88,1984-03-16,The Ice Pirates,9000000,13075390,13075390,4075390,3,0,1984,45.282111111111114
3788,89,2004-05-14,Breakin' All the Rules,9000000,12232382,12512317,3512317,5,279935,2004,39.02574444444444
3789,90,2011-08-12,Glee: The 3D Concert Movie,9000000,11862398,17462398,8462398,8,5600000,2011,94.02664444444444
3790,91,1989-11-08,Henry V,9000000,10161099,10176701,1176701,11,15602,1989,13.074455555555556
3791,92,2016-11-04,Loving,9000000,7710234,12898064,3898064,11,5187830,2016,43.311822222222226
3792,93,2007-11-28,The Savages,9000000,6623082,10642023,1642023,11,4018941,2007,18.244699999999998
3793,94,2003-04-16,Chasing Papi,9000000,6126237,12657377,3657377,4,6531140,2003,40.63752222222222
3794,95,2000-09-08,The Way of the Gun,9000000,6047856,13061935,4061935,9,7014079,2000,45.13261111111111
3795,96,2019-05-17,The Sun is Also a Star,9000000,4950029,5434029,-3565971,5,484000,2019,-39.6219
3796,97,2008-08-22,Hamlet 2,9000000,4886216,4934104,-4065896,8,47888,2008,-45.17662222222222
3797,98,2002-09-13,Igby Goes Down,9000000,4777465,4777465,-4222535,9,0,2002,-46.91705555555556
3798,99,1994-04-29,PCU,9000000,4333569,4333569,-4666431,4,0,1994,-51.84923333333333
3799,100,2007-03-09,The Ultimate Gift,9000000,3438735,3438735,-5561265,3,0,2007,-61.79183333333334
3800,1,2000-09-29,Beautiful,9000000,3134509,3134509,-5865491,9,0,2000,-65.17212222222221
3801,2,2007-06-01,Gracie,9000000,2956339,3922043,-5077957,6,965704,2007,-56.42174444444444
3802,3,2013-03-22,The Sapphires,9000000,2450867,20395040,11395040,3,17944173,2013,126.61155555555557
3803,4,2016-08-26,Greater,9000000,2000093,2000093,-6999907,8,0,2016,-77.77674444444445
3804,5,2018-12-25,Destroyer,9000000,1533324,3681096,-5318904,12,2147772,2018,-59.098933333333335
3805,6,2006-08-18,Trust the Man,9000000,1530535,2548378,-6451622,8,1017843,2006,-71.68468888888889
3806,7,2005-08-26,Undiscovered,9000000,1069318,1069318,-7930682,8,0,2005,-88.11868888888888
3807,8,1998-11-06,Velvet Goldmine,9000000,1053788,4313644,-4686356,11,3259856,1998,-52.07062222222222
3808,9,2010-05-14,Princess Kaiulani,9000000,883887,883887,-8116113,5,0,2010,-90.17903333333334
3809,10,2003-06-20,The Legend of Suriyothai,9000000,454255,454255,-8545745,6,0,2003,-94.95272222222222
3810,11,1991-10-25,Due occhi diabolici,9000000,349618,349618,-8650382,10,0,1991,-96.11535555555555
3811,12,2016-05-06,Dheepan,9000000,248795,7704357,-1295643,5,7455562,2016,-14.396033333333333
3812,13,2010-01-22,La fille du RER,9000000,208163,208163,-8791837,1,0,2010,-97.68707777777777
3813,14,2002-10-25,All or Nothing,9000000,184255,184255,-8815745,10,0,2002,-97.95272222222222
3814,15,2010-02-05,Red Riding: The Year of Our Lord 1974,9000000,148826,148826,-8851174,2,0,2010,-98.34637777777779
3815,16,2009-07-31,Flammen og Citronen,9000000,148089,1635241,-7364759,7,1487152,2009,-81.83065555555555
3816,17,2010-04-02,Leaves of Grass,9000000,70066,85527,-8914473,4,15461,2010,-99.0497
3817,18,2006-11-22,Opal Dream,9000000,14443,14443,-8985557,11,0,2006,-99.83952222222221
3818,19,2015-05-08,Skin Trade,9000000,1242,1242,-8998758,5,0,2015,-99.9862
3819,20,2014-06-17,Beneath Hill 60,9000000,0,3440939,-5559061,6,3440939,2014,-61.76734444444445
3820,21,2015-01-20,Veronika Decides to Die,9000000,0,2243,-8997757,1,2243,2015,-99.97507777777777
3821,22,1968-10-10,Barbarella,9000000,0,0,-9000000,10,0,1968,-100.0
3822,23,2013-02-01,A Haunting in Connecticut 2: The Ghosts of Georgia,9000000,0,0,-9000000,2,0,2013,-100.0
3823,24,2012-05-18,Polisse,8900000,176988,22744132,13844132,5,22567144,2012,155.55204494382022
3824,25,2015-11-13,Heist,8900000,50136,3324131,-5575869,11,3273995,2015,-62.65021348314607
3825,26,2011-02-26,Ultramarines,8900000,0,0,-8900000,2,0,2011,-100.0
3826,27,1986-09-26,Crocodile Dundee,8800000,174803506,328203506,319403506,9,153400000,1986,3629.5852954545453
3827,28,2004-12-31,The I Inside,8800000,0,0,-8800000,12,0,2004,-100.0
3828,29,2007-11-30,Awake,8600000,14373825,32968648,24368648,11,18594823,2007,283.35637209302325
3829,30,2016-11-18,Manchester by the Sea,8500000,47695371,77733867,69233867,11,30038496,2016,814.5160823529412
3830,31,2009-12-16,Crazy Heart,8500000,39471742,47417251,38917251,12,7945509,2009,457.8500117647059
3831,32,2008-08-15,Star Wars: The Clone Wars,8500000,35161554,68695443,60195443,8,33533889,2008,708.1816823529412
3832,33,2015-02-20,The DUFF,8500000,34030343,43528634,35028634,2,9498291,2015,412.10157647058827
3833,34,2014-10-31,Nightcrawler,8500000,32381218,50334418,41834418,10,17953200,2014,492.16962352941175
3834,35,1987-07-31,The Lost Boys,8500000,32222567,32222567,23722567,7,0,1987,279.08902352941175
3835,36,2019-01-16,Dragon Ball Super: Broly,8500000,30376755,122747755,114247755,1,92371000,2019,1344.0912352941175
3836,37,1979-11-07,The Rose,8500000,29200000,29200000,20700000,11,0,1979,243.52941176470586
3837,38,2013-09-27,Baggage Claim,8500000,21569509,22885836,14385836,9,1316327,2013,169.2451294117647
3838,39,2016-10-07,Middle School: The Worst Years of My Life,8500000,20007149,23311293,14811293,10,3304144,2016,174.25050588235294
3839,40,1991-03-01,Haakon Haakonsen,8500000,15024232,15024232,6524232,3,0,1991,76.75567058823529
3840,41,1999-04-23,Election,8500000,14943582,17202854,8702854,4,2259272,1999,102.38651764705881
3841,42,2007-03-09,The Namesake,8500000,13610521,20288774,11788774,3,6678253,2007,138.6914588235294
3842,43,2013-10-18,All is Lost,8500000,6263670,10386814,1886814,10,4123144,2013,22.197811764705882
3843,44,2004-02-27,Club Dread,8500000,5001655,7573551,-926449,2,2571896,2004,-10.8994
3844,45,2009-09-17,Bright Star,8500000,4444637,17220091,8720091,9,12775454,2009,102.58930588235293
3845,46,2001-09-21,Glitter,8500000,4273372,4273372,-4226628,9,0,2001,-49.725035294117646
3846,47,2014-06-13,The Rover,8500000,1109199,3180252,-5319748,6,2071053,2014,-62.585270588235296
3847,48,2004-04-23,Silmido,8500000,298347,30298347,21798347,4,30000000,2004,256.45114117647057
3848,49,2008-11-07,Repo! The Genetic Opera,8500000,140244,198883,-8301117,11,58639,2008,-97.6602
3849,50,2017-12-31,Posledniy bogatyr,8500000,0,30700192,22200192,12,30700192,2017,261.1787294117647
3850,51,2016-11-01,A.C.O.R.N.S.: Operation Crackdown,8500000,0,1353287,-7146713,11,1353287,2016,-84.07897647058824
3851,52,2010-02-12,My Name is Khan,8470000,4046336,42355526,33885526,2,38309190,2010,400.0652420306966
3852,53,2007-03-23,Namastey London,8400000,1207007,6831069,-1568931,3,5624062,2007,-18.67775
3853,54,2013-05-31,Yeh Jawaani Hai Deewani,8300000,3827466,50827466,42527466,5,47000000,2013,512.3791084337349
3854,55,1999-06-04,Limbo,8300000,2160710,2598224,-5701776,6,437514,1999,-68.69609638554218
3855,56,2007-03-16,The Wind That Shakes the Barley,8300000,1829142,25670174,17370174,3,23841032,2007,209.27920481927708
3856,57,2010-04-16,The City of Your Final Destination,8300000,493296,1353296,-6946704,4,860000,2010,-83.69522891566265
3857,58,2006-11-24,Kurtlar vadisi - Irak,8300000,0,24906717,16606717,11,24906717,2006,200.08092771084338
3858,59,1951-02-23,Quo Vadis?,8250000,30000000,30028513,21778513,2,28513,1951,263.98197575757575
3859,60,1965-03-02,The Sound of Music,8200000,163214286,286214286,278014286,3,123000000,1965,3390.4181219512197
3860,61,1984-02-17,Footloose,8200000,80000000,80000000,71800000,2,0,1984,875.609756097561
3861,62,1994-10-14,Pulp Fiction,8000000,107928762,212928762,204928762,10,105000000,1994,2561.609525
3862,63,1984-06-22,The Karate Kid,8000000,90815558,90815558,82815558,6,0,1984,1035.194475
3863,64,1979-06-22,The Muppet Movie,8000000,76657000,76657000,68657000,6,0,1979,858.2125
3864,65,1984-03-09,Splash,8000000,62599495,62599495,54599495,3,0,1984,682.4936875
3865,66,2006-07-26,Little Miss Sunshine,8000000,59891098,100642353,92642353,7,40751255,2006,1158.0294125
3866,67,2010-09-17,Easy A,8000000,58401464,76200721,68200721,9,17799257,2010,852.5090125
3867,68,1986-08-08,Stand by Me,8000000,52287414,52287414,44287414,8,0,1986,553.592675
3868,69,2003-06-27,28 Days Laterâ¦,8000000,45064915,82955633,74955633,6,37890718,2003,936.9454125000001
3869,70,1979-06-22,Escape from Alcatraz,8000000,43000000,43000000,35000000,6,0,1979,437.5
3870,71,2004-01-30,You Got Served,8000000,40066497,50811858,42811858,1,10745361,2004,535.148225
3871,72,2019-05-03,The Intruder,8000000,35095904,36005871,28005871,5,909967,2019,350.07338749999997
3872,73,2011-09-30,50/50,8000000,35016118,41334735,33334735,9,6318617,2011,416.6841875
3873,74,1996-04-03,A Thin Line Between Love & Hate,8000000,34873513,34873513,26873513,4,0,1996,335.9189125
3874,75,2015-09-02,A Walk in the Woods,8000000,29499394,37119358,29119358,9,7619964,2015,363.99197499999997
3875,76,2002-10-11,Brown Sugar,8000000,27362712,28315272,20315272,10,952560,2002,253.9409
3876,77,1992-03-13,Howards End,8000000,26124872,26317943,18317943,3,193071,1992,228.9742875
3877,78,2014-01-31,That Awkward Moment,8000000,26068955,53068955,45068955,1,27000000,2014,563.3619375000001
3878,79,2008-03-21,Shutter,8000000,25928550,47782426,39782426,3,21853876,2008,497.280325
3879,80,1981-12-25,Modern Problems,8000000,24474312,24474312,16474312,12,0,1981,205.92890000000003
3880,81,1969-12-18,On Her Majesty's Secret Service,8000000,22800000,82000000,74000000,12,59200000,1969,925.0
3881,82,1993-05-07,Much Ado About Nothing,8000000,22549338,22549338,14549338,5,0,1993,181.866725
3882,83,1992-04-10,The Player,8000000,21706101,28876702,20876702,4,7170601,1992,260.958775
3883,84,1982-11-10,Creepshow,8000000,20036244,20036244,12036244,11,0,1982,150.45305
3884,85,2006-04-28,Akeelah and the Bee,8000000,18848430,18959424,10959424,4,110994,2006,136.99280000000002
3885,86,1994-10-14,Wes Craven's New Nightmare,8000000,18090181,18090181,10090181,10,0,1994,126.12726249999999
3886,87,1999-10-01,Drive Me Crazy,8000000,17843379,22591451,14591451,10,4748072,1999,182.3931375
3887,88,2013-09-18,Enough Said,8000000,17550872,25621449,17621449,9,8070577,2013,220.26811249999997
3888,89,1998-01-16,Half Baked,8000000,17394881,17394881,9394881,1,0,1998,117.4360125
3889,90,2009-01-30,New in Town,8000000,16734283,29937909,21937909,1,13203626,2009,274.2238625
3890,91,2014-06-27,Begin Again,8000000,16170632,68838736,60838736,6,52668104,2014,760.4842
3891,92,2000-04-14,American Psycho,8000000,15070285,34270285,26270285,4,19200000,2000,328.37856250000004
3892,93,2006-05-19,See No Evil,8000000,15032800,18828036,10828036,5,3795236,2006,135.35045000000002
3893,94,2002-08-07,The Good Girl,8000000,14018296,16585503,8585503,8,2567207,2002,107.31878749999998
3894,95,2006-08-04,"Bon Cop, Bad Cop",8000000,12671300,12740705,4740705,8,69405,2006,59.258812500000005
3895,96,2009-10-30,The Boondock Saints 2: All Saints Day,8000000,10273187,10629320,2629320,10,356133,2009,32.8665
3896,97,2011-04-29,Prom,8000000,10130219,10763183,2763183,4,632964,2011,34.5397875
3897,98,1994-04-22,The Inkwell,8000000,8864699,8864699,864699,4,0,1994,10.8087375
3898,99,2000-12-29,Shadow of the Vampire,8000000,8279017,8279017,279017,12,0,2000,3.4877125
3899,100,2015-06-12,Me and Earl and the Dying Girl,8000000,6758416,9266180,1266180,6,2507764,2015,15.827250000000001
3900,1,2010-10-08,It's Kind of a Funny Story,8000000,6363628,6632950,-1367050,10,269322,2010,-17.088125
3901,2,1996-05-03,The Pallbearer,8000000,5656388,5656388,-2343612,5,0,1996,-29.295149999999996
3902,3,2000-09-22,Woman on Top,8000000,5018450,10192613,2192613,9,5174163,2000,27.4076625
3903,4,2000-05-12,Held Up,8000000,4714090,4714090,-3285910,5,0,2000,-41.073875
3904,5,2016-09-02,Morgan,8000000,3915251,7298786,-701214,9,3383535,2016,-8.765175
3905,6,2015-12-30,Anomalisa,8000000,3759286,5706168,-2293832,12,1946882,2015,-28.672900000000002
3906,7,2005-12-23,CachÃ©,8000000,3647381,19891331,11891331,12,16243950,2005,148.6416375
3907,8,2010-12-29,Another Year,8000000,3205706,20005613,12005613,12,16799907,2010,150.0701625
3908,9,2002-09-20,8 femmes,8000000,3076425,42376425,34376425,9,39300000,2002,429.7053125
3909,10,1991-01-01,Showdown in Little Tokyo,8000000,2275557,2275557,-5724443,1,0,1991,-71.5555375
3910,11,1998-09-25,Clay Pigeons,8000000,1793359,2256606,-5743394,9,463247,1998,-71.79242500000001
3911,12,2013-12-20,Le passÃ©,8000000,1335672,15752575,7752575,12,14416903,2013,96.9071875
3912,13,2018-04-06,Lean on Pete,8000000,1163056,2455027,-5544973,4,1291971,2018,-69.3121625
3913,14,2010-11-19,Made in Dagenham,8000000,1095369,15644196,7644196,11,14548827,2010,95.55245
3914,15,2008-06-06,And When Did You Last See Your Father?,8000000,1071240,2476491,-5523509,6,1405251,2008,-69.0438625
3915,16,2019-05-03,El Chicano,8000000,700261,700261,-7299739,5,0,2019,-91.2467375
3916,17,2010-03-05,The Secret of Kells,8000000,690290,3582797,-4417203,3,2892507,2010,-55.215037499999994
3917,18,1997-01-24,Prefontaine,8000000,590817,590817,-7409183,1,0,1997,-92.61478749999999
3918,19,1983-10-28,The Wicked Lady,8000000,589308,589308,-7410692,10,0,1983,-92.63365
3919,20,2006-05-05,Down in the Valley,8000000,568932,973443,-7026557,5,404511,2006,-87.8319625
3920,21,2007-05-11,Brooklyn Rules,8000000,458232,458232,-7541768,5,0,2007,-94.27210000000001
3921,22,2003-10-24,The Singing Detective,8000000,336456,524747,-7475253,10,188291,2003,-93.4406625
3922,23,2007-06-15,Fido,8000000,298110,456814,-7543186,6,158704,2007,-94.28982500000001
3923,24,2018-10-26,London Fields,8000000,252676,433732,-7566268,10,181056,2018,-94.57835
3924,25,2011-09-16,Restless,8000000,163753,2772511,-5227489,9,2608758,2011,-65.3436125
3925,26,1998-06-12,The Land Girls,8000000,146083,146083,-7853917,6,0,1998,-98.1739625
3926,27,2007-05-18,The Wendell Baker Story,8000000,127188,127188,-7872812,5,0,2007,-98.41015
3927,28,2010-10-29,Wild Target,8000000,109338,5314194,-2685806,10,5204856,2010,-33.572575
3928,29,2008-04-18,Pathology,8000000,109045,3270974,-4729026,4,3161929,2008,-59.112825
3929,30,2012-10-05,Wuthering Heights,8000000,100915,2721534,-5278466,10,2620619,2012,-65.980825
3930,31,2016-11-18,A Street Cat Named Bob,8000000,82703,17382693,9382693,11,17299990,2016,117.28366249999999
3931,32,2006-08-18,10th & Wolf,8000000,54702,143782,-7856218,8,89080,2006,-98.202725
3932,33,2015-05-22,Aloft,8000000,53086,237688,-7762312,5,184602,2015,-97.0289
3933,34,2011-10-14,Fireflies in the Garden,8000000,36884,3587191,-4412809,10,3550307,2011,-55.160112500000004
3934,35,2005-09-23,Dear Wendy,8000000,23106,446438,-7553562,9,423332,2005,-94.41952500000001
3935,36,2001-04-27,Akira,8000000,19585,19585,-7980415,4,0,2001,-99.75518749999999
3936,37,2005-12-31,Welcome to Dongmakgol,8000000,0,48000000,40000000,12,48000000,2005,500.0
3937,38,2013-09-20,Feichang Xingyun,8000000,0,21970000,13970000,9,21970000,2013,174.625
3938,39,2017-09-29,"Don Gato, el inicio de la pandilla",8000000,0,4604656,-3395344,9,4604656,2017,-42.4418
3939,40,2007-09-04,The Death and Life of Bobby Z,8000000,0,414617,-7585383,9,414617,2007,-94.8172875
3940,41,2018-04-24,Backstabbing For Beginners,8000000,0,343773,-7656227,4,343773,2018,-95.7028375
3941,42,2014-08-12,Swelter,8000000,0,44197,-7955803,8,44197,2014,-99.44753750000001
3942,43,2007-11-30,Maurice Richard,8000000,0,0,-8000000,11,0,2007,-100.0
3943,44,2015-02-24,Green Street Hooligans: Underground,8000000,0,0,-8000000,2,0,2015,-100.0
3944,45,2009-12-31,Christmas in Beverly Hills,8000000,0,0,-8000000,12,0,2009,-100.0
3945,46,2015-12-31,Henry Joseph Church,8000000,0,0,-8000000,12,0,2015,-100.0
3946,47,2016-05-06,Code of Honor,8000000,0,0,-8000000,5,0,2016,-100.0
3947,48,2019-06-21,Burn Your Maps,8000000,0,0,-8000000,6,0,2019,-100.0
3948,49,2006-01-27,Imagine Me & You,7900000,672243,3129471,-4770529,1,2457228,2006,-60.38644303797468
3949,50,2003-07-04,Swimming Pool,7800000,10130108,24021282,16221282,7,13891174,2003,207.96515384615387
3950,51,1990-02-23,The Blood of Heroes,7700000,882290,882290,-6817710,2,0,1990,-88.54168831168832
3951,52,2015-04-14,Loin des hommes,7700000,5336,1080428,-6619572,4,1075092,2015,-85.96846753246753
3952,53,1989-12-13,Driving Miss Daisy,7500000,106593296,106593296,99093296,12,0,1989,1321.2439466666665
3953,54,1997-09-26,Soul Food,7500000,43492389,43492389,35992389,9,0,1997,479.89851999999996
3954,55,2009-07-17,(500) Days of Summer,7500000,32425665,34439060,26939060,7,2013395,2009,359.18746666666664
3955,56,1996-02-23,Rumble in the Bronx,7500000,32281907,36238752,28738752,2,3956845,1996,383.18336
3956,57,2006-03-17,Thank You For Smoking,7500000,24793509,40016662,32516662,3,15223153,2006,433.55549333333335
3957,58,2007-06-08,Hostel: Part II,7500000,17544812,33606409,26106409,6,16061597,2007,348.08545333333336
3958,59,2009-10-09,An Education,7500000,12574914,29652736,22152736,10,17077822,2009,295.36981333333335
3959,60,2009-09-04,Extract,7500000,10823158,10849158,3349158,9,26000,2009,44.65544
3960,61,2002-12-20,Narc,7500000,10465659,11843260,4343260,12,1377601,2002,57.910133333333334
3961,62,2005-10-21,Shopgirl,7500000,10284523,11758418,4258418,10,1473895,2005,56.778906666666664
3962,63,1984-03-09,The Hotel New Hampshire,7500000,5142858,5142858,-2357142,3,0,1984,-31.42856
3963,64,2002-03-08,Men with Brooms,7500000,4239767,4239767,-3260233,3,0,2002,-43.469773333333336
3964,65,2008-02-22,Witless Protection,7500000,4151836,4151836,-3348164,2,0,2008,-44.64218666666667
3965,66,2004-11-24,The Work and the Glory,7500000,3347647,3347647,-4152353,11,0,2004,-55.36470666666666
3966,67,2011-12-21,Albert Nobbs,7500000,3014696,8539003,1039003,12,5524307,2011,13.853373333333332
3967,68,2016-06-24,The Neon Demon,7500000,1333124,3559803,-3940197,6,2226679,2016,-52.53596
3968,69,2003-07-24,Masked and Anonymous,7500000,533344,555335,-6944665,7,21991,2003,-92.59553333333334
3969,70,2018-04-13,Borg vs McEnroe,7500000,231346,3257922,-4242078,4,3026576,2018,-56.56104
3970,71,2002-09-13,Betty Fisher et autres histoires,7500000,206400,206400,-7293600,9,0,2002,-97.248
3971,72,2004-08-06,Code 46,7500000,197148,1788324,-5711676,8,1591176,2004,-76.15568
3972,73,2001-12-31,The Hole,7500000,0,10834406,3334406,12,10834406,2001,44.45874666666666
3973,74,2015-01-09,Black November,7500000,0,32572,-7467428,1,32572,2015,-99.56570666666667
3974,75,2015-02-24,Outside Bet,7500000,0,13524,-7486476,2,13524,2015,-99.81968
3975,76,2015-05-15,Pound of Flesh,7500000,0,0,-7500000,5,0,2015,-100.0
3976,77,2017-01-13,The Bye Bye Man,7400000,22395806,31187727,23787727,1,8791921,2017,321.4557702702703
3977,78,2007-04-27,Ta Ra Rum Pum,7400000,872643,9443864,2043864,4,8571221,2007,27.619783783783785
3978,79,2005-05-06,Crash,7303082,55334418,101173038,93869956,5,45838620,2005,1285.3471452189638
3979,80,2007-12-25,Persepolis,7300000,4443403,25397187,18097187,12,20953784,2007,247.9066712328767
3980,81,2010-04-30,Harry Brown,7300000,1818681,12023606,4723606,4,10204925,2010,64.70693150684932
3981,82,2011-05-27,Die Welle,7250000,0,35122948,27872948,5,35122948,2011,384.4544551724138
3982,83,1971-12-17,Diamonds Are Forever,7200000,43800000,116000000,108800000,12,72200000,1971,1511.111111111111
3983,84,1999-10-15,The Omega Code,7200000,12610552,12678312,5478312,10,67760,1999,76.08766666666666
3984,85,2011-09-16,3,7200000,59774,295492,-6904508,9,235718,2011,-95.89594444444445
3985,86,2007-12-05,Juno,7000000,143495265,231450102,224450102,12,87954837,2007,3206.430028571429
3986,87,1972-03-15,The Godfather,7000000,134966411,268500000,261500000,3,133533589,1972,3735.7142857142853
3987,88,2012-06-29,Magic Mike,7000000,113721571,170549753,163549753,6,56828182,2012,2336.4250428571427
3988,89,1983-04-15,Flashdance,7000000,90463574,201463574,194463574,4,111000000,1983,2778.051057142857
3989,90,2018-03-16,I Can Only Imagine,7000000,83482352,85604221,78604221,3,2121869,2018,1122.917442857143
3990,91,2019-03-15,Five Feet Apart,7000000,45729221,80504421,73504421,3,34775200,2019,1050.0631571428573
3991,92,1993-11-12,The Piano,7000000,40157856,40168957,33168957,11,11101,1993,473.8422428571429
3992,93,2011-05-06,Jumping the Broom,7000000,37295394,38158601,31158601,5,863207,2011,445.12287142857144
3993,94,1973-06-27,Live and Let Die,7000000,35400000,161800000,154800000,6,126400000,1973,2211.4285714285716
3994,95,2000-01-12,My Dog Skip,7000000,34099640,35795319,28795319,1,1695679,2000,411.3617
3995,96,2003-01-24,Darkness Falls,7000000,32539681,47289758,40289758,1,14750077,2003,575.5679714285714
3996,97,2008-02-14,"Definitely, Maybe",7000000,32241649,55617866,48617866,2,23376217,2008,694.5409428571429
3997,98,2005-10-07,"Good Night, and Good Luck",7000000,31501218,56586901,49586901,10,25085683,2005,708.3842999999999
3998,99,2005-09-30,Capote,7000000,28750530,49924079,42924079,9,21173549,2005,613.2011285714285
3999,100,1974-03-29,The Great Gatsby,7000000,26533200,26533200,19533200,3,0,1974,279.0457142857143
4000,1,2006-08-04,The Descent,7000000,26024456,57051053,50051053,8,31026597,2006,715.0150428571428
4001,2,1995-08-25,Desperado,7000000,25532388,25532388,18532388,8,0,1995,264.7484
4002,3,1976-01-01,Logan's Run,7000000,25000000,25000000,18000000,1,0,1976,257.14285714285717
4003,4,2017-04-07,Gifted,7000000,24801212,36964656,29964656,4,12163444,2017,428.0665142857143
4004,5,1996-03-08,Fargo,7000000,24567751,51204567,44204567,3,26636816,1996,631.4938142857143
4005,6,2001-04-11,Kingdom Come,7000000,23247539,23393939,16393939,4,146400,2001,234.19912857142856
4006,7,1974-12-20,The Man with the Golden Gun,7000000,21000000,97600000,90600000,12,76600000,1974,1294.2857142857142
4007,8,1988-02-12,Action Jackson,7000000,20257000,20257000,13257000,2,0,1988,189.3857142857143
4008,9,1983-05-13,Breathless,7000000,19910002,19910002,12910002,5,0,1983,184.42860000000002
4009,10,2000-05-05,Michael Jordan to the MAX,7000000,18642318,18642318,11642318,5,0,2000,166.31882857142855
4010,11,2015-06-19,Dope,7000000,17506470,18190831,11190831,6,684361,2015,159.8690142857143
4011,12,2005-07-22,The Devil's Rejects,7000000,17044981,20940428,13940428,7,3895447,2005,199.14897142857143
4012,13,2019-05-24,BrightBurn,7000000,16794432,27989498,20989498,5,11195066,2019,299.84997142857145
4013,14,2014-01-17,Devil's Due,7000000,15821461,36146087,29146087,1,20324626,2014,416.37267142857144
4014,15,1996-03-22,Flirting with Disaster,7000000,14853474,16149180,9149180,3,1295706,1996,130.70257142857142
4015,16,2014-11-14,Beyond the Lights,7000000,14618727,14618727,7618727,11,0,2014,108.83895714285714
4016,17,1992-07-31,Buffy the Vampire Slayer,7000000,14231669,14231669,7231669,7,0,1992,103.30955714285714
4017,18,1999-08-25,In Too Deep,7000000,14026509,15471229,8471229,8,1444720,1999,121.01755714285713
4018,19,2003-04-11,"House of 1,000 Corpses",7000000,12634962,17005466,10005466,4,4370504,2003,142.93522857142858
4019,20,1985-10-11,Silver Bullet,7000000,10803211,10803211,3803211,10,0,1985,54.331585714285715
4020,21,2003-10-10,House of the Dead,7000000,10199354,13860078,6860078,10,3660724,2003,98.00111428571428
4021,22,2009-10-02,A Serious Man,7000000,9228788,30360570,23360570,10,21131782,2009,333.72242857142857
4022,23,2010-07-30,Get Low,7000000,9176933,10828305,3828305,7,1651372,2010,54.69007142857143
4023,24,2009-12-11,A Single Man,7000000,9176000,28142379,21142379,12,18966379,2009,302.0339857142857
4024,25,1991-01-10,Warlock,7000000,8824553,8824553,1824553,1,0,1991,26.065042857142856
4025,26,1988-08-12,The Last Temptation of Christ,7000000,8373585,8373585,1373585,8,0,1988,19.622642857142857
4026,27,2010-06-18,Cyrus,7000000,7468936,10062896,3062896,6,2593960,2010,43.75565714285714
4027,28,1999-09-01,Outside Providence,7000000,7309628,7824358,824358,9,514730,1999,11.776542857142857
4028,29,2005-02-11,Bride & Prejudice,7000000,6601079,25269040,18269040,2,18667961,2005,260.9862857142857
4029,30,2002-11-29,Rabbit-Proof Fence,7000000,6199600,16866928,9866928,11,10667328,2002,140.95611428571428
4030,31,2007-07-27,Who's Your Caddy?,7000000,5694308,5694308,-1305692,7,0,2007,-18.652742857142858
4031,32,1992-05-01,Split Second,7000000,5430822,5430822,-1569178,5,0,1992,-22.41682857142857
4032,33,1991-03-08,Nikita,7000000,5017971,5017971,-1982029,3,0,1991,-28.3147
4033,34,2001-12-14,The Other Side of Heaven,7000000,4720371,4720371,-2279629,12,0,2001,-32.56612857142857
4034,35,1990-09-28,Dark Angel,7000000,4372561,4372561,-2627439,9,0,1990,-37.534842857142856
4035,36,1986-06-27,American Anthem,7000000,3571624,3571624,-3428376,6,0,1986,-48.9768
4036,37,2004-11-12,Veer-Zaara,7000000,2938532,7017859,17859,11,4079327,2004,0.2551285714285714
4037,38,2008-05-02,Redbelt,7000000,2344847,2667084,-4332916,5,322237,2008,-61.8988
4038,39,1999-08-27,A Dog of Flanders,7000000,2165637,2165637,-4834363,8,0,1999,-69.06232857142857
4039,40,2002-10-18,Auto Focus,7000000,2062066,2703821,-4296179,10,641755,2002,-61.373985714285716
4040,41,2011-10-21,The Mighty Macs,7000000,1891936,1891936,-5108064,10,0,2011,-72.97234285714286
4041,42,2010-12-22,Somewhere,7000000,1785645,17023121,10023121,12,15237476,2010,143.18744285714286
4042,43,2012-01-13,We Need to Talk About Kevin,7000000,1738692,10765283,3765283,1,9026591,2012,53.78975714285714
4043,44,2007-02-02,Factory Girl,7000000,1661464,1661464,-5338536,2,0,2007,-76.2648
4044,45,2013-11-15,The Christmas Candle,7000000,1632000,1933829,-5066171,11,301829,2013,-72.37387142857142
4045,46,2009-09-25,I Hope They Serve Beer in Hell,7000000,1429299,1429453,-5570547,9,154,2009,-79.57924285714286
4046,47,1983-04-08,Losin' It,7000000,1246141,1246141,-5753859,4,0,1983,-82.19798571428572
4047,48,2010-05-07,Mother and Child,7000000,1110509,6537179,-462821,5,5426670,2010,-6.611728571428571
4048,49,1977-08-05,March or Die,7000000,1000000,1000000,-6000000,8,0,1977,-85.71428571428571
4049,50,1996-07-12,Les Visiteurs,7000000,659000,98754000,91754000,7,98095000,1996,1310.7714285714285
4050,51,2015-10-02,Freeheld,7000000,546201,1732228,-5267772,10,1186027,2015,-75.25388571428572
4051,52,2014-04-02,Dom Hemingway,7000000,523511,1857458,-5142542,4,1333947,2014,-73.46488571428571
4052,53,2010-07-30,The Extra Man,7000000,453377,492108,-6507892,7,38731,2010,-92.96988571428571
4053,54,2011-05-13,Hesher,7000000,382946,382946,-6617054,5,0,2011,-94.52934285714286
4054,55,1998-03-13,Chairman of the Board,7000000,306715,306715,-6693285,3,0,1998,-95.61835714285715
4055,56,2003-02-14,Gerry,7000000,254683,719699,-6280301,2,465016,2003,-89.71858571428571
4056,57,2006-05-12,Wah-Wah,7000000,234750,463039,-6536961,5,228289,2006,-93.38515714285714
4057,58,2003-06-13,The Heart of Me,7000000,196067,196067,-6803933,6,0,2003,-97.19904285714286
4058,59,2010-03-26,Ca$h,7000000,46488,46488,-6953512,3,0,2010,-99.33588571428571
4059,60,2015-01-30,Trudno byt bogom,7000000,31443,41038,-6958962,1,9595,2015,-99.41374285714286
4060,61,2000-01-21,The Boondock Saints,7000000,30471,411874,-6588126,1,381403,2000,-94.11608571428572
4061,62,2014-01-28,Snezhnaya koroleva,7000000,0,15193977,8193977,1,15193977,2014,117.05681428571428
4062,63,2016-12-06,Oddball,7000000,0,10237229,3237229,12,10237229,2016,46.24612857142857
4063,64,2015-08-18,Z Storm,7000000,0,2053330,-4946670,8,2053330,2015,-70.66671428571428
4064,65,2015-12-31,Geroy,7000000,0,1545121,-5454879,12,1545121,2015,-77.92684285714286
4065,66,2013-07-23,Twixt,7000000,0,1268346,-5731654,7,1268346,2013,-81.88077142857144
4066,67,2015-11-20,Criminal Activities,7000000,0,386744,-6613256,11,386744,2015,-94.47508571428571
4067,68,2007-12-11,High School Musical 2,7000000,0,0,-7000000,12,0,2007,-100.0
4068,69,2008-12-12,The Kings of Appletown,7000000,0,0,-7000000,12,0,2008,-100.0
4069,70,2008-03-11,Stargate - The Ark of Truth,7000000,0,0,-7000000,3,0,2008,-100.0
4070,71,2015-09-01,Alpha & Omega: The Legend of the Saw Tooth Cave,7000000,0,0,-7000000,9,0,2015,-100.0
4071,72,1985-06-28,Pale Rider,6900000,41410568,41410568,34510568,6,0,1985,500.15315942028985
4072,73,2012-09-21,House at the End of the Street,6900000,31611916,44103982,37203982,9,12492066,2012,539.1881449275362
4073,74,1993-09-24,Dazed and Confused,6900000,7950889,7950889,1050889,9,0,1993,15.23027536231884
4074,75,2017-01-31,Two Lovers and a Bear,6840000,0,22273,-6817727,1,22273,2017,-99.67437134502924
4075,76,2010-09-17,Incendies,6800000,6857096,16038343,9238343,9,9181247,2010,135.85798529411767
4076,77,2000-08-11,AimÃ©e & Jaguar,6800000,927107,927107,-5872893,8,0,2000,-86.36607352941176
4077,78,2005-08-05,The Chumscrubber,6800000,49526,49526,-6750474,8,0,2005,-99.27167647058823
4078,79,2004-04-09,Shade,6800000,25032,9533964,2733964,4,9508932,2004,40.20535294117647
4079,80,2010-09-10,Bran Nue Dae,6750000,113568,6812530,62530,9,6698962,2010,0.9263703703703705
4080,81,2004-09-03,"Remember Me, My Love",6700000,223878,223878,-6476122,9,0,2004,-96.65853731343283
4081,82,2010-05-21,Perrierâs Bounty,6600000,828,828,-6599172,5,0,2010,-99.98745454545454
4082,83,2008-09-19,Tropa de Elite,6537890,8744,14319195,7781305,9,14310451,2008,119.01859774330863
4083,84,2014-10-03,Annabelle,6500000,84273813,256862920,250362920,10,172589107,2014,3851.7372307692303
4084,85,2008-02-01,Hannah Montana/Miley Cyrus: Best of Both Worlds Concert Tour,6500000,65281781,70712099,64212099,2,5430318,2008,987.8784461538462
4085,86,1991-07-12,Boyz n the Hood,6500000,56190094,56215095,49715095,7,25001,1991,764.8476153846154
4086,87,1987-07-24,La Bamba,6500000,54215416,54215416,47715416,7,0,1987,734.0833230769231
4087,88,1981-05-22,The Four Seasons,6500000,42488161,42488161,35988161,5,0,1981,553.6640153846154
4088,89,1980-01-01,Dressed to Kill,6500000,31899000,31899000,25399000,1,0,1980,390.75384615384615
4089,90,1993-04-02,The Adventures of Huck Finn,6500000,24103594,24103594,17603594,4,0,1993,270.8245230769231
4090,91,1999-04-09,Go!,6500000,16875273,28383441,21883441,4,11508168,1999,336.6683230769231
4091,92,2006-04-07,Friends with Money,6500000,13368437,18110152,11610152,4,4741715,2006,178.61772307692308
4092,93,1971-01-01,The Andromeda Strain,6500000,12376563,12376563,5876563,1,0,1971,90.40866153846154
4093,94,1999-10-22,Bats,6500000,10155691,10155691,3655691,10,0,1999,56.2414
4094,95,2017-10-20,Same Kind of Different as Me,6500000,6423605,6423605,-76395,10,0,2017,-1.1753076923076924
4095,96,2003-03-07,Nowhere in Africa,6500000,6173485,6173485,-326515,3,0,2003,-5.023307692307692
4096,97,2011-12-02,Shame,6500000,4002293,20412841,13912841,12,16410548,2011,214.04370769230766
4097,98,2005-05-13,Layer Cake,6500000,2339957,11745931,5245931,5,9405974,2005,80.70663076923077
4098,99,2013-05-31,The East,6500000,2274649,3027956,-3472044,5,753307,2013,-53.416061538461534
4099,100,2005-10-21,The Work and the Glory: American Zion,6500000,2025032,2025032,-4474968,10,0,2005,-68.84566153846153
4100,1,2009-11-13,The Messenger,6500000,1109660,1744952,-4755048,11,635292,2009,-73.1545846153846
4101,2,2004-07-23,A Home at the End of the World,6500000,1029017,1033810,-5466190,7,4793,2004,-84.09523076923077
4102,3,2001-08-17,Aberdeen,6500000,64148,64148,-6435852,8,0,2001,-99.01310769230768
4103,4,2011-12-31,Tracker,6500000,0,3149,-6496851,12,3149,2011,-99.95155384615386
4104,5,1984-10-26,The Terminator,6400000,38019031,78019031,71619031,10,40000000,1984,1119.0473593749998
4105,6,2004-02-27,"Good Bye, Lenin!",6400000,4063859,79384539,72984539,2,75320680,2004,1140.3834218749998
4106,7,2007-10-10,Control,6400000,871577,8902141,2502141,10,8030564,2007,39.095953125
4107,8,2009-10-09,The Damned United,6400000,449865,4199874,-2200126,10,3750009,2009,-34.376968749999996
4108,9,2008-02-22,Die FÃ¤lscher,6250000,5488570,20199663,13949663,2,14711093,2008,223.19460800000002
4109,10,1988-01-15,Return of the Living Dead Part II,6200000,9205924,9205924,3005924,1,0,1988,48.48264516129032
4110,11,2009-02-13,Gomorra,6200000,1579146,37339594,31139594,2,35760448,2009,502.25151612903227
4111,12,1995-10-20,Mallrats,6100000,2108367,2108367,-3991633,10,0,1995,-65.43660655737705
4112,13,1978-06-16,Grease,6000000,181813770,387510179,381510179,6,205696409,1978,6358.502983333333
4113,14,1986-12-19,Platoon,6000000,137963328,137978395,131978395,12,15067,1986,2199.6399166666665
4114,15,2004-06-23,Fahrenheit 9/11,6000000,119114517,221148959,215148959,6,102034442,2004,3585.815983333333
4115,16,1969-10-24,Butch Cassidy and the Sundance Kid,6000000,102308900,102310653,96310653,10,1753,1969,1605.17755
4116,17,1964-08-26,Mary Poppins,6000000,102272145,102272145,96272145,8,0,1964,1604.5357500000002
4117,18,1980-09-19,Ordinary People,6000000,52302978,52302978,46302978,9,0,1980,771.7163
4118,19,2018-05-11,Breaking In,6000000,46840590,51411620,45411620,5,4571030,2018,756.8603333333333
4119,20,1961-10-18,West Side Story,6000000,43700000,43700000,37700000,10,0,1961,628.3333333333334
4120,21,1956-10-17,Around the World in 80 Days,6000000,42000000,42000000,36000000,10,0,1956,600.0
4121,22,1980-07-25,Caddyshack,6000000,39846344,39846344,33846344,7,0,1980,564.1057333333333
4122,23,2001-03-23,The Brothers,6000000,27457409,27958191,21958191,3,500782,2001,365.96985
4123,24,2008-12-17,The Wrestler,6000000,26238243,46634275,40634275,12,20396032,2008,677.2379166666667
4124,25,1989-06-30,Do the Right Thing,6000000,26004026,26004026,20004026,6,0,1989,333.4004333333333
4125,26,1981-07-10,Escape from New York,6000000,25244700,25245925,19245925,7,1225,1981,320.7654166666666
4126,27,1999-07-16,The Wood,6000000,25059640,25059640,19059640,7,0,1999,317.66066666666666
4127,28,1995-08-16,The Usual Suspects,6000000,23341568,34449356,28449356,8,11107788,1995,474.1559333333333
4128,29,1989-08-11,A Nightmare On Elm Street: The Dream Child,6000000,22168359,22168359,16168359,8,0,1989,269.47265
4129,30,2002-04-05,National Lampoonâs Van Wilder,6000000,21305259,39241323,33241323,4,17936064,2002,554.02205
4130,31,1946-12-31,Duel in the Sun,6000000,20400000,20400000,14400000,12,0,1946,240.0
4131,32,2000-09-27,Best in Show,6000000,18621249,20695413,14695413,9,2074164,2000,244.92354999999998
4132,33,2019-03-29,Unplanned,6000000,18107621,18107621,12107621,3,0,2019,201.79368333333332
4133,34,2006-09-27,The Last King of Scotland,6000000,17606684,49155371,43155371,9,31548687,2006,719.2561833333333
4134,35,2003-04-16,A Mighty Wind,6000000,17583468,18504539,12504539,4,921071,2003,208.40898333333337
4135,36,2019-02-08,The Prodigy,6000000,14856291,19789712,13789712,2,4933421,2019,229.82853333333333
4136,37,2018-11-30,The Possession of Hannah Grace,6000000,14836174,42785387,36785387,11,27949213,2018,613.0897833333333
4137,38,1988-02-12,School Daze,6000000,14545844,14545844,8545844,2,0,1988,142.43073333333334
4138,39,2007-08-08,Daddy Day Camp,6000000,13235267,18209872,12209872,8,4974605,2007,203.49786666666665
4139,40,1988-10-21,Mystic Pizza,6000000,12793213,12793213,6793213,10,0,1988,113.22021666666666
4140,41,1998-03-20,Mr. Nice Guy,6000000,12716953,31716953,25716953,3,19000000,1998,428.61588333333333
4141,42,1956-08-21,War and Peace,6000000,12500000,12524028,6524028,8,24028,1956,108.73379999999999
4142,43,1998-04-24,Sliding Doors,6000000,11911200,58809149,52809149,4,46897949,1998,880.1524833333334
4143,44,1995-05-24,Tales from the Hood,6000000,11784569,11784569,5784569,5,0,1995,96.40948333333334
4144,45,1989-10-13,Halloween 5: The Revenge of Michael Myers,6000000,11642254,11642254,5642254,10,0,1989,94.03756666666668
4145,46,2012-09-07,The Words,6000000,11494838,16369708,10369708,9,4874870,2012,172.82846666666666
4146,47,2016-01-15,The Lady in the Van,6000000,10021175,42320503,36320503,1,32299328,2016,605.3417166666667
4147,48,2012-04-27,Bernie,6000000,9204489,10106975,4106975,4,902486,2012,68.44958333333334
4148,49,2000-12-15,Pollock,6000000,8596914,10557291,4557291,12,1960377,2000,75.95485
4149,50,2008-02-15,Dolphins and Whales Tribes of the Ocean 3D,6000000,7714996,17252287,11252287,2,9537291,2008,187.53811666666667
4150,51,1999-02-26,200 Cigarettes,6000000,6852450,6852450,852450,2,0,1999,14.207500000000001
4151,52,2010-03-19,City Island,6000000,6671283,8173486,2173486,3,1502203,2010,36.22476666666667
4152,53,2012-03-16,Casa de mi Padre,6000000,5909483,8446952,2446952,3,2537469,2012,40.78253333333333
4153,54,2011-07-29,The Guard,6000000,5359774,21197454,15197454,7,15837680,2011,253.29090000000002
4154,55,2000-04-21,The Virgin Suicides,6000000,4859475,10619770,4619770,4,5760295,2000,76.99616666666667
4155,56,2008-08-29,College,6000000,4694491,6176114,176114,8,1481623,2008,2.9352333333333336
4156,57,2006-09-22,La science des rÃªves,6000000,4670644,15137932,9137932,9,10467288,2006,152.29886666666667
4157,58,1998-12-04,Little Voice,6000000,4595000,21787233,15787233,12,17192233,1998,263.12055
4158,59,2009-03-13,Miss March,6000000,4543320,4713059,-1286941,3,169739,2009,-21.44901666666667
4159,60,1999-02-05,Simply Irresistible,6000000,4398989,4398989,-1601011,2,0,1999,-26.68351666666667
4160,61,2014-07-18,Wish I Was Here,6000000,3591299,6591365,591365,7,3000066,2014,9.856083333333334
4161,62,2006-12-21,Venus,6000000,3347411,7818479,1818479,12,4471068,2006,30.307983333333333
4162,63,2014-03-14,Veronica Mars,6000000,3322127,3485383,-2514617,3,163256,2014,-41.91028333333333
4163,64,1993-08-27,Only the Strong,6000000,3273588,3273588,-2726412,8,0,1993,-45.4402
4164,65,2001-07-20,Hedwig and the Angry Inch,6000000,3067312,3740030,-2259970,7,672718,2001,-37.66616666666667
4165,66,2003-10-31,Shattered Glass,6000000,2207975,3456602,-2543398,10,1248627,2003,-42.389966666666666
4166,67,2008-07-03,The Wackness,6000000,2077046,3330012,-2669988,7,1252966,2008,-44.4998
4167,68,2001-11-16,Novocaine,6000000,2025238,2522928,-3477072,11,497690,2001,-57.9512
4168,69,2009-02-06,Polytechnique,6000000,1418304,1418304,-4581696,2,0,2009,-76.3616
4169,70,2011-07-15,Snow Flower and the Secret Fan,6000000,1348205,11348205,5348205,7,10000000,2011,89.13674999999999
4170,71,2018-09-14,Mandy,6000000,1214525,1427656,-4572344,9,213131,2018,-76.20573333333334
4171,72,2001-12-07,The Business of Strangers,6000000,1030920,1290920,-4709080,12,260000,2001,-78.48466666666667
4172,73,2011-04-29,JÃ»san-nin no shikaku,6000000,802778,18727440,12727440,4,17924662,2011,212.12399999999997
4173,74,1991-08-30,Beastmaster 2: Through the Portal of Time,6000000,773490,773490,-5226510,8,0,1991,-87.1085
4174,75,1969-06-18,The Wild Bunch,6000000,509424,509424,-5490576,6,0,1969,-91.5096
4175,76,2011-03-25,The 5th Quarter,6000000,408159,408159,-5591841,3,0,2011,-93.19735
4176,77,1979-02-02,The First Great Train Robbery,6000000,391942,391942,-5608058,2,0,1979,-93.46763333333334
4177,78,2002-12-20,Morvern Callar,6000000,267194,267194,-5732806,12,0,2002,-95.54676666666667
4178,79,2003-10-10,The Flower of Evil,6000000,181798,181798,-5818202,10,0,2003,-96.97003333333333
4179,80,2011-03-04,Akmareul Boatda,6000000,129210,13168809,7168809,3,13039599,2011,119.48015000000001
4180,81,2006-11-10,Come Early Morning,6000000,119452,119452,-5880548,11,0,2006,-98.00913333333334
4181,82,2010-04-02,The Greatest,6000000,115862,117796,-5882204,4,1934,2010,-98.03673333333333
4182,83,2012-12-07,Deadfall,6000000,66351,1673635,-4326365,12,1607284,2012,-72.10608333333333
4183,84,2009-05-08,Julia,6000000,65108,1365108,-4634892,5,1300000,2009,-77.2482
4184,85,2002-04-05,Lucky Break,6000000,54606,4316497,-1683503,4,4261891,2002,-28.05838333333333
4185,86,2008-09-05,"Surfer, Dude",6000000,36497,36497,-5963503,9,0,2008,-99.39171666666667
4186,87,2015-01-23,Song One,6000000,32251,437089,-5562911,1,404838,2015,-92.71518333333333
4187,88,2007-10-03,Lake of Fire,6000000,25317,26007,-5973993,10,690,2007,-99.56654999999999
4188,89,2010-04-02,Don McKay,6000000,13722,13722,-5986278,4,0,2010,-99.7713
4189,90,2005-08-12,11:14,6000000,0,0,-6000000,8,0,2005,-100.0
4190,91,2010-02-09,Icarus,6000000,0,0,-6000000,2,0,2010,-100.0
4191,92,1995-12-19,Men of War,6000000,0,0,-6000000,12,0,1995,-100.0
4192,93,2011-03-15,A Shine of Rainbows,6000000,0,0,-6000000,3,0,2011,-100.0
4193,94,2011-12-31,Freaky Deaky,6000000,0,0,-6000000,12,0,2011,-100.0
4194,95,2011-05-10,The Hit List,6000000,0,0,-6000000,5,0,2011,-100.0
4195,96,1983-02-04,Videodrome,5952000,2120439,2120439,-3831561,2,0,1983,-64.37434475806452
4196,97,1996-08-02,Emma,5900000,22231658,37831658,31931658,8,15600000,1996,541.2145423728814
4197,98,2003-03-21,L\'auberge espagnole,5900000,3895664,3895664,-2004336,3,0,2003,-33.97179661016949
4198,99,1968-02-08,Planet of the Apes,5800000,33395426,33395426,27595426,2,0,1968,475.78320689655175
4199,100,1965-03-07,The Train,5800000,6800000,6800000,1000000,3,0,1965,17.24137931034483
4200,1,2011-03-18,Winter in Wartime,5800000,542860,9662214,3862214,3,9119354,2011,66.58989655172414
4201,2,2003-10-03,Foolproof,5800000,230312,421021,-5378979,10,190709,2003,-92.74101724137931
4202,3,2012-10-05,Trade of Innocents,5800000,15091,15091,-5784909,10,0,2012,-99.73981034482759
4203,4,2006-09-08,Tom yum goong,5700000,12044087,43044087,37344087,9,31000000,2006,655.1594210526316
4204,5,1999-08-27,Stiff Upper Lips,5700000,69582,69582,-5630418,8,0,1999,-98.77926315789473
4205,6,2012-09-07,The Inbetweeners,5700000,35955,86051320,80351320,9,86015365,2012,1409.6722807017545
4206,7,2010-07-16,Valhalla Rising,5700000,30638,731613,-4968387,7,700975,2010,-87.16468421052632
4207,8,2003-03-12,Bend it Like Beckham,5600000,32543449,74566042,68966042,3,42022593,2003,1231.5364642857141
4208,9,2006-09-01,Crossover,5600000,7009668,7009668,1409668,9,0,2006,25.172642857142858
4209,10,2002-06-21,Sunshine State,5600000,3064356,3281898,-2318102,6,217542,2002,-41.39467857142857
4210,11,2010-07-16,Standing Ovation,5600000,531806,531806,-5068194,7,0,2010,-90.50346428571429
4211,12,2012-12-07,Khiladi 786,5600000,385422,14683763,9083763,12,14298341,2012,162.21005357142857
4212,13,2010-07-09,[Rec] 2,5600000,27766,18527766,12927766,7,18500000,2010,230.85296428571428
4213,14,1973-12-25,The Sting,5500000,159616327,159616327,154116327,12,0,1973,2802.115036363636
4214,15,1981-09-25,Chariots of Fire,5500000,61558162,61865947,56365947,9,307785,1981,1024.8354000000002
4215,16,2005-02-25,Diary of a Mad Black Woman,5500000,50406346,50458356,44958356,2,52010,2005,817.4246545454546
4216,17,1996-11-22,Shine,5500000,35811509,36672493,31172493,11,860984,1996,566.7726
4217,18,2013-09-27,Don Jon,5500000,24477704,41268579,35768579,9,16790875,2013,650.3378
4218,19,1973-08-22,High Plains Drifter,5500000,15700000,15700000,10200000,8,0,1973,185.45454545454544
4219,20,2018-09-28,Hell Fest,5500000,11107431,18119231,12619231,9,7011800,2018,229.44056363636363
4220,21,2003-06-06,Mambo Italiano,5500000,9282750,12399772,6899772,6,3117022,2003,125.4504
4221,22,2001-07-20,Ghost World,5500000,6217849,8761608,3261608,7,2543759,2001,59.30196363636364
4222,23,2001-12-14,Iris,5500000,5580479,5580479,80479,12,0,2001,1.4632545454545456
4223,24,1980-06-06,Galaxina,5500000,4865000,4865000,-635000,6,0,1980,-11.545454545454545
4224,25,2004-11-26,Les Choristes,5500000,3629758,83529758,78029758,11,79900000,2004,1418.7228727272727
4225,26,2003-10-03,Wonderland,5500000,1060512,1060512,-4439488,10,0,2003,-80.71796363636363
4226,27,2005-07-01,De battre mon coeur s'est arrÃªtÃ©,5500000,1023424,8589831,3089831,7,7566407,2005,56.17874545454546
4227,28,2011-04-01,Haevnen,5500000,1008098,15867314,10367314,4,14859216,2011,188.49661818181818
4228,29,2011-10-21,Le Havre,5500000,611709,13480196,7980196,10,12868487,2011,145.09447272727272
4229,30,2002-05-17,Harvard Man,5500000,56653,56653,-5443347,5,0,2002,-98.96994545454545
4230,31,2011-07-15,Salvation Boulevard,5500000,28468,28468,-5471532,7,0,2011,-99.4824
4231,32,2015-01-23,R100,5500000,24956,24956,-5475044,1,0,2015,-99.54625454545454
4232,33,2015-05-05,Miss Julie,5500000,0,863895,-4636105,5,863895,2015,-84.29281818181819
4233,34,2008-12-31,Animals,5500000,0,0,-5500000,12,0,2008,-100.0
4234,35,2003-03-07,Irreversible,5400000,792200,8133256,2733256,3,7341056,2003,50.61585185185186
4235,36,2013-02-26,Tao Jie,5400000,0,4728896,-671104,2,4728896,2013,-12.427851851851852
4236,37,2006-01-27,Rang De Basanti,5300000,2197694,29197694,23897694,1,27000000,2006,450.8998867924528
4237,38,2013-07-19,Grabbers,5300000,0,440821,-4859179,7,440821,2013,-91.68262264150944
4238,39,2013-10-11,La Vie d'AdÃ¨le â Chapitres 1 & 2,5250000,2450504,22914479,17664479,10,20463975,2013,336.4662666666667
4239,40,2012-04-27,Hodejegerne,5250000,1200010,20188740,14938740,4,18988730,2012,284.5474285714286
4240,41,2007-08-03,The Ten,5250000,769726,786677,-4463323,8,16951,2007,-85.01567619047619
4241,42,2000-10-27,A Room for Romeo Brass,5250000,20097,20097,-5229903,10,0,2000,-99.6172
4242,43,2017-02-24,The Girl with all the Gifts,5250000,0,4801837,-448163,2,4801837,2017,-8.536438095238095
4243,44,1944-08-01,Wilson,5200000,2000000,2000000,-3200000,8,0,1944,-61.53846153846154
4244,45,2005-08-05,Saint Ralph,5200000,795126,1695126,-3504874,8,900000,2005,-67.40142307692307
4245,46,2011-04-22,Dum Maaro Dum,5200000,564489,11633427,6433427,4,11068938,2011,123.71974999999999
4246,47,1980-10-03,Somewhere in Time,5100000,9709597,9709597,4609597,10,0,1980,90.38425490196079
4247,48,2002-04-19,My Big Fat Greek Wedding,5000000,241438208,374890034,369890034,4,133451826,2002,7397.80068
4248,49,2017-02-24,Get Out,5000000,176040665,255367951,250367951,2,79327286,2017,5007.35902
4249,50,2017-01-20,Split,5000000,138141585,278964806,273964806,1,140823221,2017,5479.29612
4250,51,2011-10-21,Paranormal Activity 3,5000000,104028807,207039844,202039844,10,103011037,2011,4040.79688
4251,52,2005-10-28,Saw II,5000000,87025093,152925093,147925093,10,65900000,2005,2958.5018600000003
4252,53,2013-09-13,Insidious Chapter 2,5000000,83586447,161921515,156921515,9,78335068,2013,3138.4303
4253,54,2016-03-11,10 Cloverfield Lane,5000000,72082999,108286422,103286422,3,36203423,2016,2065.7284400000003
4254,55,2016-07-22,Lights Out,5000000,67268835,148806510,143806510,7,81537675,2016,2876.1302
4255,56,2015-09-11,The Visit,5000000,65206105,98677816,93677816,9,33471711,2015,1873.5563200000001
4256,57,2002-10-25,Jackass: The Movie,5000000,64282312,79282312,74282312,10,15000000,2002,1485.64624
4257,58,2017-10-13,Happy Death Day,5000000,55683845,125010260,120010260,10,69326415,2017,2400.2052
4258,59,2012-10-19,Paranormal Activity 4,5000000,53900335,142817992,137817992,10,88917657,2012,2756.35984
4259,60,2014-10-24,Ouija,5000000,50856010,103300632,98300632,10,52444622,2014,1966.01264
4260,61,1987-02-27,A Nightmare On Elm Street 3: Dream Warriors,5000000,44793222,44793222,39793222,2,0,1987,795.86444
4261,62,2013-08-30,No se Aceptan Devoluciones,5000000,44467206,100486616,95486616,8,56019410,2013,1909.73232
4262,63,2015-08-07,The Gift,5000000,43787265,58978477,53978477,8,15191212,2015,1079.56954
4263,64,2017-06-23,The Big Sick,5000000,42872467,53972860,48972860,6,11100393,2017,979.4572000000001
4264,65,1975-05-16,The Return of the Pink Panther,5000000,41833347,41833347,36833347,5,0,1975,736.6669400000001
4265,66,2019-05-31,MA,5000000,36049540,44300625,39300625,5,8251085,2019,786.0125
4266,67,1953-09-16,The Robe,5000000,36000000,36008303,31008303,9,8303,1953,620.16606
4267,68,1991-09-13,Freddyâs Dead: The Final Nightmare,5000000,34872033,34872033,29872033,9,0,1991,597.44066
4268,69,2003-12-24,Monster,5000000,34469210,64240813,59240813,12,29771603,2003,1184.81626
4269,70,2014-01-03,Paranormal Activity: The Marked Ones,5000000,32462372,90904854,85904854,1,58442482,2014,1718.09708
4270,71,1954-12-23,"20,000 Leagues Under the Sea",5000000,28200000,28200000,23200000,12,0,1954,463.99999999999994
4271,72,2014-04-11,Oculus,5000000,27695246,44115496,39115496,4,16420250,2014,782.3099199999999
4272,73,2013-11-01,Dallas Buyers Club,5000000,27298285,60611845,55611845,11,33313560,2013,1112.2369
4273,74,2015-08-26,No Escape,5000000,27288872,42844516,37844516,8,15555644,2015,756.89032
4274,75,1980-10-03,The Elephant Man,5000000,26010864,26010864,21010864,10,0,1980,420.21727999999996
4275,76,2015-02-27,The Lazarus Effect,5000000,25801570,38359310,33359310,2,12557740,2015,667.1862
4276,77,2001-03-16,Memento,5000000,25544867,39723096,34723096,3,14178229,2001,694.46192
4277,78,2011-08-26,Our Idiot Brother,5000000,24814830,25861249,20861249,8,1046419,2011,417.22498
4278,79,2018-03-09,The Strangers: Prey at Night,5000000,24431472,29960051,24960051,3,5528579,2018,499.20102
4279,80,2006-07-21,Clerks II,5000000,24148068,27342246,22342246,7,3194178,2006,446.84492
4280,81,1998-04-08,The Players Club,5000000,23047939,23047939,18047939,4,0,1998,360.95878
4281,82,2000-10-13,Billy Elliot,5000000,21995263,109253745,104253745,10,87258482,2000,2085.0749
4282,83,2013-07-05,The Way Way Back,5000000,21502690,26853810,21853810,7,5351120,2013,437.07620000000003
4283,84,2014-08-29,"As Above, So Below",5000000,21222315,41824066,36824066,8,20601751,2014,736.4813200000001
4284,85,2016-04-01,Godâs Not Dead 2,5000000,20773069,23551286,18551286,4,2778217,2016,371.02572
4285,86,1997-12-17,The Apostle,5000000,20733485,21277770,16277770,12,544285,1997,325.5554
4286,87,1982-11-03,The Man From Snowy River,5000000,20659423,20659423,15659423,11,0,1982,313.18845999999996
4287,88,1991-10-23,House Party 2,5000000,19438638,19438638,14438638,10,0,1991,288.77276
4288,89,1999-03-26,Doug's 1st Movie,5000000,19421271,19421271,14421271,3,0,1999,288.42542
4289,90,2016-02-19,Race,5000000,19115191,23745772,18745772,2,4630581,2016,374.91544
4290,91,1981-09-18,Mommie Dearest,5000000,19032000,25032000,20032000,9,6000000,1981,400.64000000000004
4291,92,2015-01-16,Still Alice,5000000,18656400,41699612,36699612,1,23043212,2015,733.99224
4292,93,1988-10-01,Halloween 4: The Return of Michael Myers,5000000,17768757,17768757,12768757,10,0,1988,255.37514
4293,94,2011-09-02,Apollo 18,5000000,17686929,26517819,21517819,9,8830890,2011,430.35638
4294,95,2018-03-23,"Paul, Apostle of Christ",5000000,17547999,25529498,20529498,3,7981499,2018,410.58995999999996
4295,96,2014-10-10,Addicted,5000000,17390770,17499242,12499242,10,108472,2014,249.98484
4296,97,2001-08-31,O (Othello),5000000,16017403,16017403,11017403,8,0,2001,220.34805999999998
4297,98,1995-09-29,Halloween: The Curse of Michael Myers,5000000,15126948,15126948,10126948,9,0,1995,202.53896
4298,99,1954-08-24,The Egyptian,5000000,15000000,15000000,10000000,8,0,1954,200.0
4299,100,1997-11-07,Eve's Bayou,5000000,14843425,14843425,9843425,11,0,1997,196.8685
4300,1,1981-04-10,Nighthawks,5000000,14600000,19600000,14600000,4,5000000,1981,292.0
4301,2,1989-07-28,Friday the 13th Part VIII: Jason Takes Manhattan,5000000,14343976,14343976,9343976,7,0,1989,186.87952
4302,3,2013-03-15,Spring Breakers,5000000,14124286,31149251,26149251,3,17024965,2013,522.98502
4303,4,2017-06-09,It Comes at Night,5000000,13985117,19720203,14720203,6,5735086,2017,294.40406
4304,5,2002-03-15,Y Tu MamÃ¡ TambiÃ©n,5000000,13649881,33649881,28649881,3,20000000,2002,572.99762
4305,6,2004-09-24,Shaun of the Dead,5000000,13542874,30332385,25332385,9,16789511,2004,506.6477
4306,7,2008-10-31,The Haunting of Molly Hartley,5000000,13442412,15318257,10318257,10,1875845,2008,206.36514
4307,8,2016-07-15,Hillaryâs America: The Secret History of the Democratic Party,5000000,13099931,13099931,8099931,7,0,2016,161.99862000000002
4308,9,1996-06-21,Lone Star,5000000,12961389,12961389,7961389,6,0,1996,159.22778
4309,10,1986-03-27,April Fool's Day,5000000,12947763,12947763,7947763,3,0,1986,158.95526
4310,11,1982-04-02,Diner,5000000,12592907,12592907,7592907,4,0,1982,151.85814
4311,12,2017-03-03,Before I Fall,5000000,12241072,18945682,13945682,3,6704610,2017,278.91364
4312,13,1983-04-15,Lone Wolf McQuade,5000000,12232628,12232628,7232628,4,0,1983,144.65256
4313,14,2009-03-13,Sunshine Cleaning,5000000,12062558,17329337,12329337,3,5266779,2009,246.58674
4314,15,2016-01-29,Fifty Shades of Black,5000000,11686940,22113075,17113075,1,10426135,2016,342.2615
4315,16,1957-12-14,A Farewell To Arms,5000000,11000000,11017403,6017403,12,17403,1957,120.34806
4316,17,1959-01-01,Solomon and Sheba,5000000,11000000,11014961,6014961,1,14961,1959,120.29921999999999
4317,18,1982-08-20,The Beastmaster,5000000,10751126,10751126,5751126,8,0,1982,115.02252
4318,19,2009-01-09,Not Easily Broken,5000000,10572742,10732909,5732909,1,160167,2009,114.65818000000002
4319,20,2014-05-09,Momsâ Night Out,5000000,10429707,10537341,5537341,5,107634,2014,110.74682
4320,21,2017-03-17,The Belko Experiment,5000000,10166820,11792942,6792942,3,1626122,2017,135.85884
4321,22,2016-03-11,The Perfect Match,5000000,9669521,10182050,5182050,3,512529,2016,103.641
4322,23,2000-10-06,Digimon: The Movie,5000000,9628751,16628751,11628751,10,7000000,2000,232.57502
4323,24,2004-05-28,Saved!,5000000,8886160,10206551,5206551,5,1320391,2004,104.13102
4324,25,2003-05-09,Les invasions barbares,5000000,8460000,25913869,20913869,5,17453869,2003,418.27738
4325,26,1976-03-11,Robin and Marian,5000000,8000000,8000000,3000000,3,0,1976,60.0
4326,27,1978-12-22,Force 10 from Navarone,5000000,7100000,7100000,2100000,12,0,1978,42.0
4327,28,2001-04-27,The Forsaken,5000000,6755271,6755271,1755271,4,0,2001,35.105419999999995
4328,29,2018-09-21,Fahrenheit 11/9,5000000,6352306,6653715,1653715,9,301409,2018,33.0743
4329,30,1989-07-21,UHF,5000000,6157157,6157157,1157157,7,0,1989,23.143140000000002
4330,31,2010-05-28,Sea Rex 3D: Journey to a Prehistoric World,5000000,6096582,16515203,11515203,5,10418621,2010,230.30406000000002
4331,32,2006-01-06,Grandmaâs Boy,5000000,6090172,6590172,1590172,1,500000,2006,31.80344
4332,33,1998-08-14,Slums of Beverly Hills,5000000,5502773,5502773,502773,8,0,1998,10.05546
4333,34,1969-05-28,Once Upon a Time in the West,5000000,5321508,5378425,378425,5,56917,1969,7.5685
4334,35,2001-07-13,Made,5000000,5308707,5476060,476060,7,167353,2001,9.5212
4335,36,2004-11-19,La mala educaciÃ³n,5000000,5211842,40311842,35311842,11,35100000,2004,706.23684
4336,37,2009-06-12,Moon,5000000,5010163,10676073,5676073,6,5665910,2009,113.52146
4337,38,2015-09-11,90 Minutes in Heaven,5000000,4816142,4816142,-183858,9,0,2015,-3.67716
4338,39,2016-12-02,Incarnate,5000000,4799774,9371036,4371036,12,4571262,2016,87.42072
4339,40,2006-05-12,Keeping Up with the Steins,5000000,4339241,4414753,-585247,5,75512,2006,-11.70494
4340,41,1997-10-10,The Sweet Hereafter,5000000,4306697,7951247,2951247,10,3644550,1997,59.02494
4341,42,2008-08-06,Bottle Shock,5000000,4078607,4815890,-184110,8,737283,2008,-3.6822
4342,43,2011-02-25,Des Hommes et Des Dieux,5000000,3954651,46263525,41263525,2,42308874,2011,825.2705000000001
4343,44,1982-08-27,Jekyll and Hyde... Together Again,5000000,3707583,3707583,-1292417,8,0,1982,-25.848339999999997
4344,45,2017-03-03,Table 19,5000000,3614896,4620399,-379601,3,1005503,2017,-7.59202
4345,46,2016-04-15,Green Room,5000000,3220371,3807503,-1192497,4,587132,2016,-23.84994
4346,47,2018-03-09,Thoroughbreds,5000000,3072605,3187302,-1812698,3,114697,2018,-36.25396
4347,48,1994-11-16,Heavenly Creatures,5000000,3046086,5438120,438120,11,2392034,1994,8.7624
4348,49,2016-03-04,The Other Side of the Door,5000000,3000342,12905107,7905107,3,9904765,2016,158.10214
4349,50,2011-05-13,Everything Must Go,5000000,2712131,2821010,-2178990,5,108879,2011,-43.5798
4350,51,2014-10-10,Kill the Messenger,5000000,2450846,6656705,1656705,10,4205859,2014,33.1341
4351,52,2010-12-17,Rabbit Hole,5000000,2229058,6205034,1205034,12,3975976,2010,24.10068
4352,53,2015-10-23,Jem and the Holograms,5000000,2184640,2368937,-2631063,10,184297,2015,-52.62126000000001
4353,54,2016-12-28,Paterson,5000000,2141423,10727536,5727536,12,8586113,2016,114.55072
4354,55,1998-01-30,Zero Effect,5000000,2080693,2080693,-2919307,1,0,1998,-58.38614
4355,56,1992-04-24,A Midnight Clear,5000000,1526697,1526697,-3473303,4,0,1992,-69.46606
4356,57,2004-10-22,The Machinist,5000000,1082044,8655397,3655397,10,7573353,2004,73.10794
4357,58,1992-09-21,Light Sleeper,5000000,1050861,1050861,-3949139,9,0,1992,-78.98277999999999
4358,59,2008-07-25,American Teen,5000000,942441,989319,-4010681,7,46878,2008,-80.21361999999999
4359,60,2014-09-12,Atlas Shrugged: Who Is John Galt?,5000000,851690,851690,-4148310,9,0,2014,-82.9662
4360,61,2003-08-29,Party Monster,5000000,742898,894030,-4105970,8,151132,2003,-82.1194
4361,62,2006-07-14,The Oh in Ohio,5000000,418689,648183,-4351817,7,229494,2006,-87.03634
4362,63,1996-02-21,Bottle Rocket,5000000,407488,407488,-4592512,2,0,1996,-91.85024
4363,64,2013-08-16,Ain't Them Bodies Saints,5000000,391611,1075009,-3924991,8,683398,2013,-78.49982
4364,65,1997-01-17,Albino Alligator,5000000,353480,353480,-4646520,1,0,1997,-92.9304
4365,66,2014-09-26,Jimi: All is By My Side,5000000,340911,927074,-4072926,9,586163,2014,-81.45852000000001
4366,67,2007-08-03,"Gandhi, My Father",5000000,240425,2015004,-2984996,8,1774579,2007,-59.69991999999999
4367,68,2008-04-25,Standard Operating Procedure,5000000,228830,332120,-4667880,4,103290,2008,-93.35759999999999
4368,69,2011-09-30,Tucker & Dale vs. Evil,5000000,223838,5476793,476793,9,5252955,2011,9.53586
4369,70,1998-03-27,No Looking Back,5000000,143273,143273,-4856727,3,0,1998,-97.13454
4370,71,2015-08-07,Cop Car,5000000,134552,143658,-4856342,8,9106,2015,-97.12684
4371,72,2010-09-10,"Lovely, Still",5000000,127564,282687,-4717313,9,155123,2010,-94.34626
4372,73,2003-06-13,Tycoon,5000000,121016,121016,-4878984,6,0,2003,-97.57968
4373,74,1999-06-04,Desert Blue,5000000,99147,99147,-4900853,6,0,1999,-98.01706
4374,75,2004-02-27,Decoys,5000000,84733,96760,-4903240,2,12027,2004,-98.06479999999999
4375,76,2008-05-30,Stuck,5000000,67505,67505,-4932495,5,0,2008,-98.6499
4376,77,2007-11-16,Redacted,5000000,65388,861325,-4138675,11,795937,2007,-82.7735
4377,78,2014-10-17,Rudderless,5000000,56001,567219,-4432781,10,511218,2014,-88.65562
4378,79,2005-01-28,Fascination,5000000,16670,83356,-4916644,1,66686,2005,-98.33288
4379,80,2009-08-14,Grace,5000000,8297,8297,-4991703,8,0,2009,-99.83406000000001
4380,81,2015-05-15,Area 51,5000000,7556,7556,-4992444,5,0,2015,-99.84888
4381,82,2012-10-26,Mientras duermes,5000000,0,9109597,4109597,10,9109597,2012,82.19194
4382,83,2009-07-07,Flying By,5000000,0,4568257,-431743,7,4568257,2009,-8.63486
4383,84,2008-12-31,The Cottage,5000000,0,1504960,-3495040,12,1504960,2008,-69.90079999999999
4384,85,2014-12-05,Dying of the Light,5000000,0,74639,-4925361,12,74639,2014,-98.50721999999999
4385,86,2016-09-02,Yoga Hosers,5000000,0,22958,-4977042,9,22958,2016,-99.54084
4386,87,2009-02-17,Dead Like Me: Life After Death,5000000,0,0,-5000000,2,0,2009,-100.0
4387,88,2007-01-30,Farce of the Penguins,5000000,0,0,-5000000,1,0,2007,-100.0
4388,89,2010-12-31,Psych 9,5000000,0,0,-5000000,12,0,2010,-100.0
4389,90,2014-11-21,Reach Me,5000000,0,0,-5000000,11,0,2014,-100.0
4390,91,2014-08-18,Henry & Me,5000000,0,0,-5000000,8,0,2014,-100.0
4391,92,2015-01-27,Born of War,5000000,0,0,-5000000,1,0,2015,-100.0
4392,93,2015-01-09,Let's Kill Ward's Wife,5000000,0,0,-5000000,1,0,2015,-100.0
4393,94,2015-01-13,Capricorn One,5000000,0,0,-5000000,1,0,2015,-100.0
4394,95,2011-12-31,We Have Your Husband,5000000,0,0,-5000000,12,0,2011,-100.0
4395,96,2012-12-31,Should've Been Romeo,5000000,0,0,-5000000,12,0,2012,-100.0
4396,97,2015-12-31,Aztec Warrior,5000000,0,0,-5000000,12,0,2015,-100.0
4397,98,2015-09-25,Navy SEAL vs. Zombies,5000000,0,0,-5000000,9,0,2015,-100.0
4398,99,2016-03-15,The Hatching,5000000,0,0,-5000000,3,0,2016,-100.0
4399,100,2015-10-27,Running Forever,5000000,0,0,-5000000,10,0,2015,-100.0
4400,1,2015-01-23,Mommy,4900000,3498695,17536004,12636004,1,14037309,2015,257.87763265306126
4401,2,2008-08-29,Obsluhoval jsem anglickÃ©ho krÃ¡le,4900000,617228,7174984,2274984,8,6557756,2008,46.42824489795918
4402,3,2010-08-20,Soul Kitchen,4900000,276901,23347461,18447461,8,23070560,2010,376.4787959183673
4403,4,2012-08-17,The Awakening,4900000,95933,6924321,2024321,8,6828388,2012,41.312673469387754
4404,5,2008-01-18,All Hat,4900000,15198,15198,-4884802,1,0,2008,-99.68983673469388
4405,6,1996-11-20,Sling Blade,4833610,24475416,34175000,29341390,11,9699584,1996,607.0284942310199
4406,7,2006-01-06,Hostel,4800000,47326473,82241110,77441110,1,34914637,2006,1613.3564583333332
4407,8,2013-07-19,Only God Forgives,4800000,775849,4494560,-305440,7,3718711,2013,-6.363333333333333
4408,9,2011-09-30,Take Shelter,4750000,1728953,4972016,222016,9,3243063,2011,4.674021052631579
4409,10,2006-01-27,Tristram Shandy: A Cock and Bull Story,4750000,1253413,3061763,-1688237,1,1808350,2006,-35.54183157894737
4410,11,1986-08-22,The Texas Chainsaw Massacre 2,4700000,8025872,8025872,3325872,8,0,1986,70.7632340425532
4411,12,1988-04-22,Lady in White,4700000,1705139,1705139,-2994861,4,0,1988,-63.72044680851063
4412,13,2006-10-13,Driving Lessons,4700000,239962,239962,-4460038,10,0,2006,-94.89442553191489
4413,14,2011-12-31,Without Men,4700000,0,0,-4700000,12,0,2011,-100.0
4414,15,2015-03-10,Treading Water,4700000,0,0,-4700000,3,0,2015,-100.0
4415,16,1973-05-23,Pat Garrett and Billy the Kid,4638783,8000000,11000000,6361217,5,3000000,1973,137.13116134123973
4416,17,2004-07-16,Camping Sauvage,4600000,3479302,3479302,-1120698,7,0,2004,-24.363
4417,18,2012-09-14,Barfi,4600000,2804874,36751984,32151984,9,33947110,2012,698.9561739130435
4418,19,2005-03-04,Dear Frankie,4600000,1340891,3099369,-1500631,3,1758478,2005,-32.62241304347826
4419,20,2004-12-29,The Assassination of Richard Nixon,4600000,708776,4880143,280143,12,4171367,2004,6.090065217391304
4420,21,2011-06-24,Le nom des gens,4600000,514237,9261711,4661711,6,8747474,2011,101.34154347826087
4421,22,2008-05-28,Savage Grace,4600000,434417,968805,-3631195,5,534388,2008,-78.93902173913044
4422,23,2007-10-19,Out of the Blue,4600000,728,731767,-3868233,10,731039,2007,-84.09202173913044
4423,24,1984-03-23,Police Academy,4500000,81198894,81198894,76698894,3,0,1984,1704.4198666666666
4424,25,1994-03-09,Four Weddings and a Funeral,4500000,52700832,242895809,238395809,3,190194977,1994,5297.6846444444445
4425,26,1980-06-20,The Blue Lagoon,4500000,47923795,47923795,43423795,6,0,1980,964.9732222222223
4426,27,1982-08-13,Fast Times at Ridgemont High,4500000,27092880,27092880,22592880,8,0,1982,502.064
4427,28,1996-09-28,Secrets & Lies,4500000,13417292,13417292,8917292,9,0,1996,198.16204444444446
4428,29,2002-12-19,25th Hour,4500000,13084595,25344490,20844490,12,12259895,2002,463.2108888888889
4429,30,1985-09-13,After Hours,4500000,10609321,10609321,6109321,9,0,1985,135.7626888888889
4430,31,1956-06-27,Moby Dick,4500000,10400000,10400000,5900000,6,0,1956,131.11111111111111
4431,32,2016-03-25,The Lobster,4500000,9196278,18019834,13519834,3,8823556,2016,300.44075555555554
4432,33,1996-10-04,Bound,4500000,3802260,7011317,2511317,10,3209057,1996,55.80704444444444
4433,34,2000-10-06,Requiem for a Dream,4500000,3635482,7389233,2889233,10,3753751,2000,64.20517777777778
4434,35,1962-03-09,State Fair,4500000,3500000,3500000,-1000000,3,0,1962,-22.22222222222222
4435,36,2008-10-24,LÃ¥t den rÃ¤tte komma in,4500000,2122085,12247682,7747682,10,10125597,2008,172.1707111111111
4436,37,1999-02-12,Tango,4500000,1687311,5428387,928387,2,3741076,1999,20.63082222222222
4437,38,1986-04-23,Salvador,4500000,1500000,1500000,-3000000,4,0,1986,-66.66666666666666
4438,39,2001-10-26,Donnie Darko,4500000,1480006,7510877,3010877,10,6030871,2001,66.90837777777779
4439,40,2011-09-02,Salvando al Soldado Perez,4500000,1400726,9330465,4830465,9,7929739,2011,107.34366666666666
4440,41,1998-03-27,Karakter,4500000,713413,713413,-3786587,3,0,1998,-84.14637777777779
4441,42,2011-08-19,Nannerl la soeur de Mozart,4500000,707885,2404639,-2095361,8,1696754,2011,-46.56357777777777
4442,43,2003-03-14,Spun,4500000,410241,1022649,-3477351,3,612408,2003,-77.27446666666667
4443,44,2010-07-23,Life During Wartime,4500000,281447,281447,-4218553,7,0,2010,-93.74562222222222
4444,45,2006-05-04,Chinjeolhan geumjassi,4500000,211667,23471871,18971871,5,23260204,2006,421.5971333333333
4445,46,2011-10-07,Blackthorn,4500000,200558,1217307,-3282693,10,1016749,2011,-72.94873333333334
4446,47,2015-05-08,Maggie,4500000,187112,1027760,-3472240,5,840648,2015,-77.16088888888889
4447,48,2003-04-18,Lilja 4-ever,4500000,181655,4556982,56982,4,4375327,2003,1.2662666666666667
4448,49,2010-04-09,After.Life,4500000,108596,2481925,-2018075,4,2373329,2010,-44.84611111111111
4449,50,2002-02-22,Mean Machine,4500000,92723,92723,-4407277,2,0,2002,-97.93948888888889
4450,51,2007-08-31,Fong juk,4500000,51957,51957,-4448043,8,0,2007,-98.84540000000001
4451,52,2010-07-23,Spoken Word,4500000,32961,32961,-4467039,7,0,2010,-99.26753333333333
4452,53,2013-03-01,The Sweeney,4500000,26345,8000366,3500366,3,7974021,2013,77.7859111111111
4453,54,2014-09-04,Falcon Rising,4500000,11774,11774,-4488226,9,0,2014,-99.73835555555556
4454,55,2013-06-25,Hansel & Gretel Get Baked,4500000,0,0,-4500000,6,0,2013,-100.0
4455,56,2014-11-07,Fugly,4500000,0,0,-4500000,11,0,2014,-100.0
4456,57,2015-08-28,Zipper,4500000,0,0,-4500000,8,0,2015,-100.0
4457,58,2015-11-03,The Final Girls,4500000,0,0,-4500000,11,0,2015,-100.0
4458,59,2017-12-01,Daisy Winters,4500000,0,0,-4500000,12,0,2017,-100.0
4459,60,1975-11-19,One Flew Over the Cuckoo's Nest,4400000,108981275,108997629,104597629,11,16354,1975,2377.218840909091
4460,61,1976-06-25,Silent Movie,4400000,36145695,36145695,31745695,6,0,1976,721.4930681818182
4461,62,2016-12-31,Airlift (2016),4400000,0,9969237,5569237,12,9969237,2016,126.57356818181817
4462,63,2015-09-29,R.L. Stine's Monsterville: The Cabinet of Souls,4400000,0,0,-4400000,9,0,2015,-100.0
4463,64,2014-06-06,Anna,4357373,0,1200000,-3157373,6,1200000,2014,-72.46047102233388
4464,65,2003-06-06,Whale Rider,4300000,20779666,39374600,35074600,6,18594934,2003,815.6883720930233
4465,66,2001-06-13,Sexy Beast,4300000,6946056,10158355,5858355,6,3212299,2001,136.24081395348838
4466,67,2009-12-04,Paa,4300000,199228,9791282,5491282,12,9592054,2009,127.70423255813954
4467,68,2012-07-11,Snabba Cash,4300000,188870,10212403,5912403,7,10023533,2012,137.49774418604653
4468,69,1990-10-19,Night of the Living Dead,4200000,5835247,5835247,1635247,10,0,1990,38.934452380952386
4469,70,2006-02-17,Nochnoy dozor,4200000,1502188,33913542,29713542,2,32411354,2006,707.4652857142858
4470,71,2010-08-13,Animal Kingdom,4200000,1044039,8078683,3878683,8,7034644,2010,92.34959523809523
4471,72,2010-05-28,George A. Romero's Survival of the Dead,4200000,101740,101740,-4098260,5,0,2010,-97.57761904761905
4472,73,2011-10-21,Cargo,4200000,0,313230,-3886770,10,313230,2011,-92.54214285714286
4473,74,2006-05-23,High School Musical,4200000,0,0,-4200000,5,0,2006,-100.0
4474,75,1998-03-06,Love and Death on Long Island,4030000,2542264,2542264,-1487736,3,0,1998,-36.91652605459057
4475,76,1982-03-19,Porky's,4000000,109492484,109492484,105492484,3,0,1982,2637.3121
4476,77,1953-02-05,Peter Pan,4000000,87400000,87400000,83400000,2,0,1953,2085.0
4477,78,1992-11-25,The Crying Game,4000000,62546695,62546695,58546695,11,0,1992,1463.667375
4478,79,2003-09-12,Lost in Translation,4000000,44585453,117085297,113085297,9,72499844,2003,2827.132425
4479,80,1977-04-20,Annie Hall,4000000,38251425,38251425,34251425,4,0,1977,856.285625
4480,81,2015-01-23,The Boy Next Door,4000000,36006065,53401938,49401938,1,17395873,2015,1235.04845
4481,82,1952-01-10,The Greatest Show on Earth,4000000,36000000,36000000,32000000,1,0,1952,800.0
4482,83,1995-10-27,Leaving Las Vegas,4000000,31983777,49800000,45800000,10,17816223,1995,1145.0
4483,84,2001-12-26,Monster's Ball,4000000,31273922,43766463,39766463,12,12492541,2001,994.1615750000001
4484,85,2014-07-11,Boyhood,4000000,25379975,57273049,53273049,7,31893074,2014,1331.826225
4485,86,1960-12-15,Exodus,4000000,21750000,21750000,17750000,12,0,1960,443.75
4486,87,2010-07-09,The Kids Are All Right,4000000,20811365,36275469,32275469,7,15464104,2010,806.8867250000001
4487,88,1979-08-17,Life of Brian,4000000,20182359,20468305,16468305,8,285946,1979,411.707625
4488,89,2014-04-18,A Haunted House 2,4000000,17329487,21206861,17206861,4,3877374,2014,430.171525
4489,90,2013-03-01,The Last Exorcism Part II,4000000,15179303,25448707,21448707,3,10269404,2013,536.217675
4490,91,1974-12-17,The Front Page,4000000,15000000,15000000,11000000,12,0,1974,275.0
4491,92,1956-05-30,Trapeze,4000000,14400000,14400000,10400000,5,0,1956,260.0
4492,93,1985-08-16,The Return of the Living Dead,4000000,14237880,14237880,10237880,8,0,1985,255.947
4493,94,1988-11-04,They Live,4000000,13000000,13000774,9000774,11,774,1988,225.01935
4494,95,2000-08-04,Saving Grace,4000000,12178602,27786849,23786849,8,15608247,2000,594.671225
4495,96,1963-08-08,The Great Escape,4000000,11744471,11972561,7972561,8,228090,1963,199.314025
4496,97,2004-02-06,What the #$'! Do We Know,4000000,10941801,10941801,6941801,2,0,2004,173.545025
4497,98,2016-05-13,The Darkness,4000000,10753574,10898293,6898293,5,144719,2016,172.457325
4498,99,2006-07-28,Scoop,4000000,10525717,40103262,36103262,7,29577545,2006,902.58155
4499,100,2001-11-14,The Wash,4000000,10097096,10097096,6097096,11,0,2001,152.42739999999998
4500,1,2000-03-01,3 Strikes,4000000,9821335,9821335,5821335,3,0,2000,145.533375
4501,2,2008-04-11,The Visitor,4000000,9427026,19174817,15174817,4,9747791,2008,379.37042499999995
4502,3,2003-11-26,The Cooler,4000000,8291572,11131455,7131455,11,2839883,2003,178.286375
4503,4,1961-02-01,The Misfits,4000000,8200000,8200000,4200000,2,0,1961,105.0
4504,5,2006-08-04,The Night Listener,4000000,7836393,10770993,6770993,8,2934600,2006,169.274825
4505,6,1995-02-03,The Jerky Boys,4000000,7555256,7555256,3555256,2,0,1995,88.8814
4506,7,2007-12-28,El orfanato,4000000,7159147,79250193,75250193,12,72091046,2007,1881.254825
4507,8,2007-05-25,Bug,4000000,7006708,8302995,4302995,5,1296287,2007,107.574875
4508,9,2002-10-11,The Rules of Attraction,4000000,6525762,11799060,7799060,10,5273298,2002,194.9765
4509,10,1969-12-19,Topaz,4000000,6000000,6000000,2000000,12,0,1969,50.0
4510,11,2006-11-17,Let's Go to Prison,4000000,4630045,4630045,630045,11,0,2006,15.751124999999998
4511,12,1995-12-25,Four Rooms,4000000,4301000,4301000,301000,12,0,1995,7.5249999999999995
4512,13,2002-09-20,Secretary,4000000,4046737,9413956,5413956,9,5367219,2002,135.3489
4513,14,2003-04-25,The Real Cancun,4000000,3816594,3816594,-183406,4,0,2003,-4.5851500000000005
4514,15,1988-12-01,Talk Radio,4000000,3468572,3468572,-531428,12,0,1988,-13.2857
4515,16,1997-01-31,Waiting for Guffman,4000000,2922988,2922988,-1077012,1,0,1997,-26.925300000000004
4516,17,1999-09-10,Love Stinks,4000000,2793776,2793776,-1206224,9,0,1999,-30.1556
4517,18,2012-08-24,Samsara,4000000,2672413,5966671,1966671,8,3294258,2012,49.166775
4518,19,2007-06-22,You Kill Me,4000000,2426851,3858964,-141036,6,1432113,2007,-3.5259
4519,20,2011-06-17,The Art of Getting By,4000000,1430241,1989035,-2010965,6,558794,2011,-50.274125000000005
4520,21,2005-09-16,Thumbsucker,4000000,1328679,1919197,-2080803,9,590518,2005,-52.020075
4521,22,2011-09-23,Red State,4000000,1065429,1983596,-2016404,9,918167,2011,-50.4101
4522,23,2005-09-30,MirrorMask,4000000,864959,973613,-3026387,9,108654,2005,-75.65967500000001
4523,24,1987-03-31,The Barbarians,4000000,800000,800000,-3200000,3,0,1987,-80.0
4524,25,2012-10-17,Holy Motors,4000000,641054,4230426,230426,10,3589372,2012,5.76065
4525,26,2014-06-13,The Signal,4000000,600896,2665322,-1334678,6,2064426,2014,-33.36695
4526,27,2003-02-28,Poolhall Junkies,4000000,563711,563711,-3436289,2,0,2003,-85.907225
4527,28,1999-05-28,The Loss of Sexual Innocence,4000000,399793,399793,-3600207,5,0,1999,-90.00517500000001
4528,29,2014-03-07,The Face of Love,4000000,385069,1158877,-2841123,3,773808,2014,-71.028075
4529,30,2014-04-11,Joe,4000000,373375,373375,-3626625,4,0,2014,-90.665625
4530,31,1988-03-04,Prison,4000000,354704,354704,-3645296,3,0,1988,-91.1324
4531,32,1998-05-01,Shooting Fish,4000000,302204,302204,-3697796,5,0,1998,-92.44489999999999
4532,33,2009-05-08,Adoration,4000000,294244,384244,-3615756,5,90000,2009,-90.3939
4533,34,2000-08-04,Psycho Beach Party,4000000,267972,267972,-3732028,8,0,2000,-93.3007
4534,35,2019-06-07,Late Night,4000000,246305,246305,-3753695,6,0,2019,-93.842375
4535,36,2000-01-28,The Big Tease,4000000,185577,185577,-3814423,1,0,2000,-95.360575
4536,37,2017-08-25,Polina danser sa vie,4000000,165203,953314,-3046686,8,788111,2017,-76.16714999999999
4537,38,2015-04-10,Desert Dancer,4000000,155271,596335,-3403665,4,441064,2015,-85.09162500000001
4538,39,2015-01-30,"Guten Tag, Ramon",4000000,154356,4854356,854356,1,4700000,2015,21.3589
4539,40,2003-07-25,Mondays in the Sun,4000000,146402,146402,-3853598,7,0,2003,-96.33995
4540,41,2015-06-19,Manglehorn,4000000,132270,797439,-3202561,6,665169,2015,-80.064025
4541,42,2010-04-02,Tau ming chong,4000000,129078,38899792,34899792,4,38770714,2010,872.4947999999999
4542,43,2011-04-01,Trust,4000000,120016,120016,-3879984,4,0,2011,-96.9996
4543,44,2000-12-22,An Everlasting Piece,4000000,75078,75078,-3924922,12,0,2000,-98.12305
4544,45,1999-03-26,Among Giants,4000000,64359,64359,-3935641,3,0,1999,-98.391025
4545,46,1999-07-16,The Velocity of Gary,4000000,34145,34145,-3965855,7,0,1999,-99.14637499999999
4546,47,2011-04-22,Stake Land,4000000,33245,679482,-3320518,4,646237,2011,-83.01294999999999
4547,48,2015-02-27,Praia do Futuro,4000000,20620,760678,-3239322,2,740058,2015,-80.98305
4548,49,2002-12-27,Sonny,4000000,17639,17639,-3982361,12,0,2002,-99.559025
4549,50,1997-06-20,The Last Time I Committed Suicide,4000000,12836,12836,-3987164,6,0,1997,-99.6791
4550,51,2014-04-18,13 Sins,4000000,9134,47552,-3952448,4,38418,2014,-98.8112
4551,52,2011-11-18,Another Happy Day,4000000,9120,978527,-3021473,11,969407,2011,-75.536825
4552,53,2013-02-22,Inescapable,4000000,4327,4327,-3995673,2,0,2013,-99.891825
4553,54,2017-12-31,Perfectos Desconocidos,4000000,0,31166312,27166312,12,31166312,2017,679.1578000000001
4554,55,2013-12-31,Geograf globus propil,4000000,0,4454853,454853,12,4454853,2013,11.371325
4555,56,2012-03-20,A Lonely Place to Die,4000000,0,442550,-3557450,3,442550,2012,-88.93625
4556,57,2003-12-31,Nothing,4000000,0,63180,-3936820,12,63180,2003,-98.4205
4557,58,2012-06-01,The Loved Ones,4000000,0,12302,-3987698,6,12302,2012,-99.69245
4558,59,1972-11-09,1776,4000000,0,0,-4000000,11,0,1972,-100.0
4559,60,1930-11-15,Hell's Angels,4000000,0,0,-4000000,11,0,1930,-100.0
4560,61,2008-08-26,Purple Violets,4000000,0,0,-4000000,8,0,2008,-100.0
4561,62,2012-11-09,Replicas,4000000,0,0,-4000000,11,0,2012,-100.0
4562,63,2012-12-31,The Helpers,4000000,0,0,-4000000,12,0,2012,-100.0
4563,64,2015-12-31,The Veil,4000000,0,0,-4000000,12,0,2015,-100.0
4564,65,2014-07-11,The Perfect Wave,4000000,0,0,-4000000,7,0,2014,-100.0
4565,66,2012-12-31,How to Fall in Love,4000000,0,0,-4000000,12,0,2012,-100.0
4566,67,2015-09-08,Chain of Command,4000000,0,0,-4000000,9,0,2015,-100.0
4567,68,1939-12-15,Gone with the Wind,3900000,198680470,390525192,386625192,12,191844722,1939,9913.466461538463
4568,69,1966-12-12,A Man for All Seasons,3900000,28350000,28350000,24450000,12,0,1966,626.9230769230769
4569,70,1925-12-30,Ben-Hur: A Tale of the Christ,3900000,9000000,9000000,5100000,12,0,1925,130.76923076923077
4570,71,1976-01-01,Network,3800000,23689877,23689877,19889877,1,0,1976,523.4178157894737
4571,72,2011-01-14,Down for Life,3800000,41914,41914,-3758086,1,0,2011,-98.897
4572,73,2010-04-30,The Good Heart,3800000,20930,340930,-3459070,4,320000,2010,-91.02815789473684
4573,74,1965-04-07,Major Dundee,3800000,14873,14873,-3785127,4,0,1965,-99.60860526315788
4574,75,2018-10-05,Hevi reissu,3800000,10153,10153,-3789847,10,0,2018,-99.73281578947368
4575,76,1974-12-31,The Taking of Pelham One Two Three,3800000,0,0,-3800000,12,0,1974,-100.0
4576,77,1950-05-17,Annie Get Your Gun,3768785,8000000,8000000,4231215,5,0,1950,112.27000213596689
4577,78,2006-08-11,Casa de Areia,3750000,539285,1178175,-2571825,8,638890,2006,-68.582
4578,79,2010-11-05,Four Lions,3750000,310007,2436111,-1313889,11,2126104,2010,-35.037040000000005
4579,80,2010-02-19,Defendor,3750000,44462,44462,-3705538,2,0,2010,-98.81434666666667
4580,81,1970-05-13,The Ballad of Cable Hogue,3716946,3500000,5000000,1283054,5,1500000,1970,34.51903794136369
4581,82,1948-05-20,The Pirate,3700000,2956000,2956000,-744000,5,0,1948,-20.10810810810811
4582,83,2006-11-21,The History Boys,3700000,2730296,13447998,9747998,11,10717702,2006,263.4594054054054
4583,84,2006-11-03,Unknown,3700000,26403,3355048,-344952,11,3328645,2006,-9.323027027027027
4584,85,1969-05-25,Midnight Cowboy,3600000,44785053,44785053,41185053,5,0,1969,1144.02925
4585,86,2008-10-10,Billy: The Early Years of Billy Graham,3600000,320896,320896,-3279104,10,0,2008,-91.08622222222222
4586,87,2017-12-31,UtÃ¸ya 22. juli,3600000,0,173156,-3426844,12,173156,2017,-95.19011111111111
4587,88,1980-07-04,Airplane!,3500000,83453539,83453539,79953539,7,0,1980,2284.386828571429
4588,89,1970-01-01,M*A*S*H,3500000,81600000,81600000,78100000,1,0,1970,2231.428571428571
4589,90,1997-08-13,The Full Monty,3500000,45950122,261249383,257749383,8,215299261,1997,7364.268085714286
4590,91,2018-04-13,Truth or Dare,3500000,41411015,95127344,91627344,4,53716329,2018,2617.9241142857145
4591,92,1993-05-26,Menace II Society,3500000,27731527,27731527,24231527,5,0,1993,692.3293428571428
4592,93,1995-04-26,Friday,3500000,27467564,27936778,24436778,4,469214,1995,698.1936571428571
4593,94,2016-02-19,The Witch,3500000,25138705,40454520,36954520,2,15315815,2016,1055.8434285714286
4594,95,2018-02-02,Winchester,3500000,25091816,44378040,40878040,2,19286224,2018,1167.944
4595,96,2002-12-06,Empire,3500000,17504595,18495444,14995444,12,990849,2002,428.4412571428572
4596,97,2013-02-22,Dark Skies,3500000,17418667,27704111,24204111,2,10285444,2013,691.5460285714286
4597,98,2018-01-19,Forever My Girl,3500000,16376066,16376066,12876066,1,0,2018,367.88759999999996
4598,99,1987-05-01,Creepshow 2,3500000,14000000,14000000,10500000,5,0,1987,300.0
4599,100,1967-12-14,In Cold Blood,3500000,13000000,13007551,9507551,12,7551,1967,271.6443142857143
4600,1,1959-07-18,The Nun's Story,3500000,12800000,12800000,9300000,7,0,1959,265.7142857142857
4601,2,1972-06-21,Frenzy,3500000,12600000,12600000,9100000,6,0,1972,260.0
4602,3,1966-02-23,Harper,3500000,12000000,12000000,8500000,2,0,1966,242.85714285714283
4603,4,1998-05-27,I Got the Hook-Up!,3500000,10317779,10317779,6817779,5,0,1998,194.79368571428571
4604,5,1996-08-23,She's the One,3500000,9482579,13795053,10295053,8,4312474,1996,294.1443714285714
4605,6,1980-01-01,Terror Train,3500000,8000000,8000000,4500000,1,0,1980,128.57142857142858
4606,7,1998-11-06,Gods and Monsters,3500000,6451628,6451628,2951628,11,0,1998,84.33222857142857
4607,8,2010-04-16,El secreto de sus ojos,3500000,6391436,40527719,37027719,4,34136283,2010,1057.9348285714286
4608,9,1987-03-13,Evil Dead II,3500000,5923044,5926177,2426177,3,3133,1987,69.31934285714286
4609,10,1985-06-30,Day of the Dead,3500000,5804262,34004262,30504262,6,28200000,1985,871.5503428571429
4610,11,2018-05-18,First Reformed,3500000,3448256,3874772,374772,5,426516,2018,10.707771428571428
4611,12,2001-06-29,Pootie Tang,3500000,3293258,3293258,-206742,6,0,2001,-5.906914285714286
4612,13,2016-12-02,Believe,3500000,890303,890303,-2609697,12,0,2016,-74.56277142857142
4613,14,2000-04-19,La otra conquista,3500000,886410,886410,-2613590,4,0,2000,-74.67399999999999
4614,15,2016-09-30,American Honey,3500000,663247,2611750,-888250,9,1948503,2016,-25.378571428571426
4615,16,2016-03-18,The Bronze,3500000,615816,615816,-2884184,3,0,2016,-82.40525714285715
4616,17,2011-06-10,Trolljegeren,3500000,253444,5706638,2206638,6,5453194,2011,63.046800000000005
4617,18,2007-09-14,Ira and Abby,3500000,221096,221096,-3278904,9,0,2007,-93.68297142857142
4618,19,2016-01-08,The Masked Saint,3500000,182695,182695,-3317305,1,0,2016,-94.78014285714286
4619,20,2006-02-17,Winter Passing,3500000,107492,113783,-3386217,2,6291,2006,-96.74905714285714
4620,21,2005-03-25,D.E.B.S.,3500000,96793,96793,-3403207,3,0,2005,-97.23448571428571
4621,22,2016-06-03,Time to Choose,3500000,29233,29233,-3470767,6,0,2016,-99.16477142857143
4622,23,2009-06-26,Surveillance,3500000,27349,1396395,-2103605,6,1369046,2009,-60.102999999999994
4623,24,1999-09-17,Taxman,3500000,9871,9871,-3490129,9,0,1999,-99.71797142857143
4624,25,2011-12-31,The Kick,3500000,0,40622,-3459378,12,40622,2011,-98.83937142857143
4625,26,2009-06-30,The Betrayed,3500000,0,0,-3500000,6,0,2009,-100.0
4626,27,2006-10-01,The Secret,3500000,0,0,-3500000,10,0,2006,-100.0
4627,28,2011-06-28,2:13,3500000,0,0,-3500000,6,0,2011,-100.0
4628,29,2013-01-29,"Batman: The Dark Knight Returns, Part 2",3500000,0,0,-3500000,1,0,2013,-100.0
4629,30,2014-03-11,In the Name of the King III,3500000,0,0,-3500000,3,0,2014,-100.0
4630,31,2014-03-04,Wicked Blood,3500000,0,0,-3500000,3,0,2014,-100.0
4631,32,2015-06-05,Dawn Patrol,3500000,0,0,-3500000,6,0,2015,-100.0
4632,33,2013-05-17,Jagten,3450000,687185,18309793,14859793,5,17622608,2013,430.7186376811594
4633,34,2015-09-01,Lords of London,3440000,0,0,-3440000,9,0,2015,-100.0
4634,35,2005-06-24,La marche de l'empereur,3400000,77437223,133276359,129876359,6,55839136,2005,3819.8929117647062
4635,36,1977-12-23,High Anxiety,3400000,31063038,31063038,27663038,12,0,1977,813.6187647058824
4636,37,2011-10-21,Margin Call,3400000,5353586,20433227,17033227,10,15079641,2011,500.9772647058823
4637,38,2008-09-26,Choke,3400000,2926565,4124277,724277,9,1197712,2008,21.302264705882354
4638,39,2004-04-23,L\'incomparable mademoiselle C.,3400000,493905,493905,-2906095,4,0,2004,-85.47338235294117
4639,40,2008-07-11,August,3400000,12636,12636,-3387364,7,0,2008,-99.62835294117647
4640,41,2015-03-03,To Write Love On Her Arms,3400000,0,0,-3400000,3,0,2015,-100.0
4641,42,1956-02-16,Carousel,3380000,0,3604,-3376396,2,3604,1956,-99.8933727810651
4642,43,2014-10-10,Whiplash,3300000,13092006,38969037,35669037,10,25877031,2014,1080.879909090909
4643,44,2007-10-26,Bella,3300000,8093373,12405473,9105473,10,4312100,2007,275.9234242424243
4644,45,2003-01-17,Cidade de Deus,3300000,7563397,32059295,28759295,1,24495898,2003,871.4937878787879
4645,46,2000-05-05,Human Traffic,3300000,104257,5422740,2122740,5,5318483,2000,64.32545454545455
4646,47,2006-12-29,The Dead Girl,3300000,19875,19875,-3280125,12,0,2006,-99.39772727272728
4647,48,2015-01-20,The Opposite Sex,3300000,0,50206,-3249794,1,50206,2015,-98.47860606060605
4648,49,1983-11-18,A Christmas Story,3250000,20605209,20605209,17355209,11,0,1983,534.0064307692307
4649,50,1982-08-20,Class of 1984,3250000,6965361,6965361,3715361,8,0,1982,114.31880000000001
4650,51,2009-01-30,Entre les murs,3250000,3766810,34114067,30864067,1,30347257,2009,949.6636000000001
4651,52,1999-10-29,Dreaming of Joseph Lees,3250000,7680,7680,-3242320,10,0,1999,-99.76369230769231
4652,53,1968-06-12,Rosemary's Baby,3200000,33395426,33395426,30195426,6,0,1968,943.6070625
4653,54,2018-07-06,Sorry to Bother You,3200000,17493096,18285560,15085560,7,792464,2018,471.42375000000004
4654,55,1962-04-22,The Man Who Shot Liberty Valance,3200000,8000000,8000000,4800000,4,0,1962,150.0
4655,56,2004-07-16,Maria Full of Grace,3200000,6529624,14441158,11241158,7,7911534,2004,351.2861875
4656,57,2011-06-03,Beginners,3200000,5790894,14314407,11114407,6,8523513,2011,347.32521875
4657,58,2016-04-22,The Meddler,3200000,4267219,5526942,2326942,4,1259723,2016,72.7169375
4658,59,2009-07-29,Adam,3200000,2283291,2834485,-365515,7,551194,2009,-11.42234375
4659,60,2006-09-22,Feast,3200000,56131,690872,-2509128,9,634741,2006,-78.41025
4660,61,1946-12-20,Itâs a Wonderful Life,3180000,6600000,10768908,7588908,12,4168908,1946,238.64490566037736
4661,62,1996-07-19,Trainspotting,3100000,16501785,71558971,68458971,7,55057186,1996,2208.3539032258063
4662,63,2013-04-12,Antiviral,3100000,0,123407,-2976593,4,123407,2013,-96.01912903225806
4663,64,1978-07-28,National Lampoon's Animal House,3000000,141600000,141600000,138600000,7,0,1978,4620.0
4664,65,2010-10-20,Paranormal Activity 2,3000000,84752907,177512032,174512032,10,92759125,2010,5817.067733333333
4665,66,2015-08-28,War Room,3000000,67790117,73975239,70975239,8,6185122,2015,2365.8413
4666,67,2013-06-07,The Purge,3000000,64473115,91266581,88266581,6,26793466,2013,2942.2193666666667
4667,68,1964-12-22,Goldfinger,3000000,51100000,124900000,121900000,12,73800000,1964,4063.3333333333335
4668,69,2012-10-12,Sinister,3000000,48086903,87727807,84727807,10,39640904,2012,2824.2602333333334
4669,70,2000-08-18,The Original Kings of Comedy,3000000,38168022,38236338,35236338,8,68316,2000,1174.5446
4670,71,1957-12-18,The Bridge on the River Kwai,3000000,33300000,33300000,30300000,12,0,1957,1010.0
4671,72,1978-01-01,Coming Home,3000000,32653000,32653000,29653000,1,0,1978,988.4333333333334
4672,73,1998-11-20,Waking Ned Devine,3000000,24793251,55193251,52193251,11,30400000,1998,1739.7750333333333
4673,74,1997-08-01,Air Bud,3000000,24646936,27788649,24788649,8,3141713,1997,826.2883
4674,75,2002-10-11,Bowling for Columbine,3000000,21576018,58240487,55240487,10,36664469,2002,1841.3495666666665
4675,76,1985-11-01,A Nightmare on Elm Street Part 2: Freddy's Revenge,3000000,21163999,21163999,18163999,11,0,1985,605.4666333333333
4676,77,1986-03-07,A Room with a View,3000000,20966644,20966644,17966644,3,0,1986,598.8881333333334
4677,78,1975-06-10,Love and Death,3000000,20123742,20123742,17123742,6,0,1975,570.7914
4678,79,1986-08-01,Friday the 13th Part VI: Jason Lives,3000000,19472057,19472057,16472057,8,0,1986,549.0685666666667
4679,80,2002-08-02,Martin Lawrence Live: RunTelDat,3000000,19184820,19184820,16184820,8,0,2002,539.494
4680,81,1960-06-15,The Apartment,3000000,18600000,24600000,21600000,6,6000000,1960,720.0
4681,82,1958-09-20,Cat on a Hot Tin Roof,3000000,17570324,17570324,14570324,9,0,1958,485.67746666666665
4682,83,1970-05-26,Beneath the Planet of the Apes,3000000,17489009,17489009,14489009,5,0,1970,482.9669666666667
4683,84,2001-04-06,Pokemon 3: The Movie,3000000,17052128,68452128,65452128,4,51400000,2001,2181.7376
4684,85,1993-08-13,Jason Goes to Hell: The Final Friday,3000000,15935068,15935068,12935068,8,0,1993,431.16893333333337
4685,86,1990-04-27,Spaced Invaders,3000000,15000000,15000000,12000000,4,0,1990,400.0
4686,87,1976-04-09,Family Plot,3000000,13200000,13200000,10200000,4,0,1976,340.0
4687,88,1966-07-16,Torn Curtain,3000000,13000000,13000000,10000000,7,0,1966,333.33333333333337
4688,89,2018-06-01,Upgrade,3000000,11977130,16553285,13553285,6,4576155,2018,451.7761666666667
4689,90,2006-03-03,Dave Chappelle's Block Party,3000000,11718595,12051924,9051924,3,333329,2006,301.7308
4690,91,1985-10-25,Krush Groove,3000000,11052713,11052713,8052713,10,0,1985,268.42376666666667
4691,92,1960-07-07,Elmer Gantry,3000000,10400000,10400000,7400000,7,0,1960,246.66666666666669
4692,93,2009-05-08,Next Day Air,3000000,10027047,10172519,7172519,5,145472,2009,239.08396666666664
4693,94,1961-12-19,Judgment at Nuremberg,3000000,10000000,10000000,7000000,12,0,1961,233.33333333333334
4694,95,1998-11-04,Belly,3000000,9639390,9639390,6639390,11,0,1998,221.31300000000002
4695,96,1999-05-12,Trippinâ,3000000,9017070,9017070,6017070,5,0,1999,200.569
4696,97,1948-08-26,Red River,3000000,9012000,9012000,6012000,8,0,1948,200.4
4697,98,2001-08-08,The Deep End,3000000,8823109,9981635,6981635,8,1158526,2001,232.72116666666665
4698,99,2013-05-24,Before Midnight,3000000,8110621,23251930,20251930,5,15141309,2013,675.0643333333334
4699,100,1987-11-20,Teen Wolf Too,3000000,7888000,7888000,4888000,11,0,1987,162.93333333333334
4700,1,2009-07-31,The Collector,3000000,7712114,10473836,7473836,7,2761722,2009,249.12786666666668
4701,2,1988-07-08,Phantasm II,3000000,7282851,7282851,4282851,7,0,1988,142.7617
4702,3,2017-10-27,Let There Be Light,3000000,7233471,7241309,4241309,10,7838,2017,141.37696666666665
4703,4,2006-04-07,Phat Girlz,3000000,7061128,7301115,4301115,4,239987,2006,143.3705
4704,5,2004-10-01,Woman Thou Art Loosed,3000000,6879730,6879730,3879730,10,0,2004,129.32433333333333
4705,6,2002-10-18,Real Women Have Curves,3000000,5853194,7777790,4777790,10,1924596,2002,159.25966666666667
4706,7,1981-08-28,Gallipoli,3000000,5732587,5732587,2732587,8,0,1981,91.08623333333334
4707,8,2006-04-28,Water,3000000,5529144,11322573,8322573,4,5793429,2006,277.4191
4708,9,2016-07-22,Donât Think Twice,3000000,4417983,4417983,1417983,7,0,2016,47.2661
4709,10,2016-06-24,Swiss Army Man,3000000,4210454,5837111,2837111,6,1626657,2016,94.57036666666667
4710,11,2000-04-14,East is East,3000000,4170647,30438635,27438635,4,26267988,2000,914.6211666666666
4711,12,2000-09-01,Whipped,3000000,4142507,4142507,1142507,9,0,2000,38.08356666666667
4712,13,1997-02-28,Kama Sutra,3000000,4109095,4109095,1109095,2,0,1997,36.969833333333334
4713,14,2013-05-17,Frances Ha,3000000,4067398,11262769,8262769,5,7195371,2013,275.42563333333334
4714,15,2010-04-30,Please Give,3000000,4033574,4570178,1570178,4,536604,2010,52.33926666666666
4715,16,1971-06-30,Willy Wonka & the Chocolate Factory,3000000,4000000,4000000,1000000,6,0,1971,33.33333333333333
4716,17,1993-09-24,Warlock: The Armageddon,3000000,3902679,3902679,902679,9,0,1993,30.0893
4717,18,1997-04-18,8 Heads in a Duffel Bag,3000000,3602884,4002884,1002884,4,400000,1997,33.42946666666667
4718,19,1978-09-13,Days of Heaven,3000000,3446749,3660880,660880,9,214131,1978,22.029333333333334
4719,20,2002-05-24,Thirteen Conversations About One Thing,3000000,3287435,3705923,705923,5,418488,2002,23.530766666666665
4720,21,2016-04-22,Compadres,3000000,3127773,7445044,4445044,4,4317271,2016,148.16813333333334
4721,22,1999-02-19,Jawbreaker,3000000,3076820,3076820,76820,2,0,1999,2.5606666666666666
4722,23,1996-08-09,Basquiat,3000000,2962051,2962051,-37949,8,0,1996,-1.2649666666666666
4723,24,2006-02-24,Tsotsi,3000000,2912606,11537539,8537539,2,8624933,2006,284.58463333333333
4724,25,2010-04-09,Letters to God,3000000,2848587,3237452,237452,4,388865,2010,7.915066666666666
4725,26,1998-10-16,Happiness,3000000,2746453,5746453,2746453,10,3000000,1998,91.54843333333334
4726,27,2003-04-04,DysFunkTional Family,3000000,2255000,2255000,-745000,4,0,2003,-24.833333333333332
4727,28,2014-09-19,Tusk,3000000,1821983,1887554,-1112446,9,65571,2014,-37.08153333333333
4728,29,2017-05-12,The Wall,3000000,1803064,4495262,1495262,5,2692198,2017,49.84206666666667
4729,30,2003-10-24,Elephant,3000000,1266955,10051516,7051516,10,8784561,2003,235.05053333333333
4730,31,2012-04-06,Damsels in Distress,3000000,1007535,1324299,-1675701,4,316764,2012,-55.856700000000004
4731,32,2005-03-25,Oldboy,3000000,707391,6239723,3239723,3,5532332,2005,107.99076666666667
4732,33,2011-05-06,Hobo with a Shotgun,3000000,703372,834953,-2165047,5,131581,2011,-72.16823333333333
4733,34,2015-05-08,The D Train,3000000,669688,772366,-2227634,5,102678,2015,-74.25446666666666
4734,35,2012-09-07,Bachelorette,3000000,446770,12577401,9577401,9,12130631,2012,319.24670000000003
4735,36,2010-01-15,Fish Tank,3000000,374675,5922292,2922292,1,5547617,2010,97.40973333333334
4736,37,2008-09-05,Everybody Wants to Be Italian,3000000,351416,351416,-2648584,9,0,2008,-88.28613333333334
4737,38,2011-09-09,Creature,3000000,331000,331000,-2669000,9,0,2011,-88.96666666666667
4738,39,2016-12-09,The Bounce Back,3000000,321910,421404,-2578596,12,99494,2016,-85.9532
4739,40,1996-08-23,Freeway,3000000,295493,295493,-2704507,8,0,1996,-90.15023333333333
4740,41,2006-10-06,Love's Abiding Joy,3000000,252726,252726,-2747274,10,0,2006,-91.5758
4741,42,1993-02-12,Dead Alive,3000000,242623,242623,-2757377,2,0,1993,-91.91256666666666
4742,43,2010-10-01,Chain Letter,3000000,205842,1022453,-1977547,10,816611,2010,-65.91823333333333
4743,44,2012-03-02,Tim and Eric's Billion Dollar Movie,3000000,201436,223652,-2776348,3,22216,2012,-92.54493333333333
4744,45,2007-11-09,Holly,3000000,163069,163069,-2836931,11,0,2007,-94.56436666666667
4745,46,2010-03-26,The Eclipse,3000000,133411,133411,-2866589,3,0,2010,-95.55296666666668
4746,47,2008-03-21,The Grand,3000000,115879,115879,-2884121,3,0,2008,-96.13736666666667
4747,48,2006-03-17,Sommersturm,3000000,95204,95204,-2904796,3,0,2006,-96.82653333333333
4748,49,2014-08-15,Fort McCoy,3000000,78948,78948,-2921052,8,0,2014,-97.3684
4749,50,1999-08-04,The Gambler,3000000,51773,101773,-2898227,8,50000,1999,-96.60756666666667
4750,51,2000-10-13,Just Looking,3000000,39852,39852,-2960148,10,0,2000,-98.6716
4751,52,2015-09-04,Before We Go,3000000,37151,483938,-2516062,9,446787,2015,-83.86873333333334
4752,53,2012-01-13,The Divide,3000000,18000,156362,-2843638,1,138362,2012,-94.78793333333333
4753,54,2011-09-09,Tanner Hall,3000000,5073,5073,-2994927,9,0,2011,-99.8309
4754,55,2005-09-30,My Big Fat Independent Movie,3000000,4655,4655,-2995345,9,0,2005,-99.84483333333334
4755,56,2017-10-10,Demonic,3000000,0,4668109,1668109,10,4668109,2017,55.603633333333335
4756,57,2008-04-15,Ã l\'intÃ©rieur,3000000,0,895932,-2104068,4,895932,2008,-70.1356
4757,58,2014-06-27,They Came Together,3000000,0,82780,-2917220,6,82780,2014,-97.24066666666667
4758,59,2013-05-21,Open Road,3000000,0,47469,-2952531,5,47469,2013,-98.4177
4759,60,1951-07-28,Alice in Wonderland,3000000,0,0,-3000000,7,0,1951,-100.0
4760,61,2010-10-01,Barry Munday,3000000,0,0,-3000000,10,0,2010,-100.0
4761,62,2009-12-31,The Deported,3000000,0,0,-3000000,12,0,2009,-100.0
4762,63,2009-12-31,Chicago Overcoat,3000000,0,0,-3000000,12,0,2009,-100.0
4763,64,2011-09-13,Never Back Down 2: The Beatdown,3000000,0,0,-3000000,9,0,2011,-100.0
4764,65,2015-12-31,AWOL-72,3000000,0,0,-3000000,12,0,2015,-100.0
4765,66,2013-01-15,30 Nights Of Paranormal Activity With The Devil Inside The Girl With The Dragon Tattoo,3000000,0,0,-3000000,1,0,2013,-100.0
4766,67,2015-02-06,Enter the Dangerous Mind,3000000,0,0,-3000000,2,0,2015,-100.0
4767,68,2015-03-17,Something Wicked,3000000,0,0,-3000000,3,0,2015,-100.0
4768,69,1967-09-18,Point Blank,3000000,0,0,-3000000,9,0,1967,-100.0
4769,70,2014-10-27,Iguana,3000000,0,0,-3000000,10,0,2014,-100.0
4770,71,2009-12-31,Four Single Fathers,3000000,0,0,-3000000,12,0,2009,-100.0
4771,72,2015-08-14,Amnesiac,3000000,0,0,-3000000,8,0,2015,-100.0
4772,73,2015-12-31,Unnatural,3000000,0,0,-3000000,12,0,2015,-100.0
4773,74,2015-12-11,Close Range,3000000,0,0,-3000000,12,0,2015,-100.0
4774,75,1946-01-18,The Harvey Girls,2931000,4100000,4100000,1169000,1,0,1946,39.88399863527806
4775,76,1950-02-15,Cinderella,2900000,85000000,263591415,260691415,2,178591415,1950,8989.359137931035
4776,77,1998-11-20,Central do Brasil,2900000,5969553,17006158,14106158,11,11036605,1998,486.4192413793104
4777,78,1961-12-19,Pocketful of Miracles,2900000,5000000,5000000,2100000,12,0,1961,72.41379310344827
4778,79,2006-03-24,Boynton Beach Club,2900000,3127472,3127472,227472,3,0,2006,7.8438620689655165
4779,80,2010-10-01,Freakonomics,2900000,101270,172867,-2727133,10,71597,2010,-94.03906896551723
4780,81,2011-08-19,Griff the Invisible,2900000,20778,25935,-2874065,8,5157,2011,-99.10568965517241
4781,82,1959-03-29,Some Like it Hot,2883848,25000000,25019542,22135694,3,19542,1959,767.5749207309124
4782,83,2005-06-10,High Tension,2850000,3681066,6435262,3585262,6,2754196,2005,125.79866666666666
4783,84,1974-12-15,Young Frankenstein,2800000,86300000,86300000,83500000,12,0,1974,2982.1428571428573
4784,85,1976-06-25,The Omen,2800000,48570885,48570885,45770885,6,0,1976,1634.6744642857143
4785,86,2005-07-22,Hustle & Flow,2800000,22202809,23591783,20791783,7,1388974,2005,742.5636785714286
4786,87,1988-05-13,Friday the 13th Part VII: The New Blood,2800000,19170001,19170001,16370001,5,0,1988,584.6428928571428
4787,88,2006-09-15,Artie Lange's Beer League,2800000,475000,475000,-2325000,9,0,2006,-83.03571428571429
4788,89,1939-08-25,The Wizard of Oz,2777000,34063405,34305476,31528476,8,242071,1939,1135.3430320489738
4789,90,2008-02-15,Diary of the Dead,2750000,952620,5394447,2644447,2,4441827,2008,96.16170909090908
4790,91,1979-10-17,The Black Stallion,2700000,37799643,37799643,35099643,10,0,1979,1299.986777777778
4791,92,1997-06-13,Ulee's Gold,2700000,9054736,15600000,12900000,6,6545264,1997,477.77777777777777
4792,93,2018-10-26,Indivisible,2700000,3511417,3588305,888305,10,76888,2018,32.90018518518519
4793,94,2006-09-01,Lage Raho Munna Bhai,2700000,2217561,31517561,28817561,9,29300000,2006,1067.317074074074
4794,95,2015-12-31,Sardaar Ji,2700000,0,8200000,5500000,12,8200000,2015,203.70370370370372
4795,96,2008-12-31,Rejsen til Saturn,2700000,0,5377665,2677665,12,5377665,2008,99.17277777777778
4796,97,1963-06-12,Donovan's Reef,2686000,6600000,6600000,3914000,6,0,1963,145.71854058078927
4797,98,1956-01-12,Diane,2660000,0,0,-2660000,1,0,1956,-100.0
4798,99,1998-01-16,The Dress,2650000,16556,16556,-2633444,1,0,1998,-99.37524528301887
4799,100,1943-12-24,A Guy Named Joe,2627000,5363000,5363000,2736000,12,0,1943,104.14921964217739
4800,1,1974-02-07,Blazing Saddles,2600000,119500000,119500000,116900000,2,0,1974,4496.153846153846
4801,2,1984-04-13,Friday the 13th Part IV: The Final Chapter,2600000,32980880,32980880,30380880,4,0,1984,1168.4953846153846
4802,3,2014-05-02,Ida,2600000,3827060,15298355,12698355,5,11471295,2014,488.39826923076924
4803,4,1987-01-01,Maurice,2600000,3147950,3198308,598308,1,50358,1987,23.011846153846154
4804,5,2004-07-09,Riding Giants,2600000,2276368,3292333,692333,7,1015965,2004,26.628192307692306
4805,6,2008-12-12,Los CronocrÃ­menes,2600000,39127,564474,-2035526,12,525347,2008,-78.28946153846154
4806,7,2011-12-31,La Cara Oculta,2600000,0,7033931,4433931,12,7033931,2011,170.53580769230769
4807,8,2007-12-07,Timber Falls,2600000,0,71248,-2528752,12,71248,2007,-97.2596923076923
4808,9,2008-12-31,Silver Medalist,2600000,0,0,-2600000,12,0,2008,-100.0
4809,10,2011-04-01,"Fat, Sick & Nearly Dead",2600000,0,0,-2600000,4,0,2011,-100.0
4810,11,1952-04-10,Singin' in the Rain,2540000,7200000,7200000,4660000,4,0,1952,183.46456692913387
4811,12,2013-01-11,A Haunted House,2500000,40041683,59922558,57422558,1,19880875,2013,2296.9023199999997
4812,13,2012-07-13,2016: Obamaâs America,2500000,33349941,33349941,30849941,7,0,2012,1233.99764
4813,14,2013-07-03,Kevin Hart: Let Me Explain,2500000,32244051,32327255,29827255,7,83204,2013,1193.0901999999999
4814,15,2004-07-28,Garden State,2500000,26782316,36028802,33528802,7,9246486,2004,1341.15208
4815,16,1996-10-04,That Thing You Do!,2500000,25857416,34557416,32057416,10,8700000,1996,1282.29664
4816,17,1981-10-30,Halloween II,2500000,25533818,25533818,23033818,10,0,1981,921.35272
4817,18,1982-10-22,Halloween 3: Season of the Witch,2500000,14400000,14400000,11900000,10,0,1982,476.0
4818,19,2008-10-01,Religulous,2500000,13011160,13881317,11381317,10,870157,2008,455.25268
4819,20,1971-01-01,Escape from the Planet of the Apes,2500000,12300000,12300000,9800000,1,0,1971,392.0
4820,21,1963-05-29,Hud,2500000,10000000,10000000,7500000,5,0,1963,300.0
4821,22,2013-08-02,The Spectacular Now,2500000,6852971,6916951,4416951,8,63980,2013,176.67804
4822,23,1991-09-29,My Own Private Idaho,2500000,6401336,6401336,3901336,9,0,1991,156.05344000000002
4823,24,1995-01-27,Before Sunrise,2500000,5274005,5690220,3190220,1,416215,1995,127.60879999999999
4824,25,2016-06-24,Hunt for the Wilderpeople,2500000,5205471,23845533,21345533,6,18640062,2016,853.8213199999999
4825,26,2012-08-17,Robot & Frank,2500000,3317468,4934356,2434356,8,1616888,2012,97.37424
4826,27,2003-10-03,Sur Le Seuil,2500000,2013052,2013052,-486948,10,0,2003,-19.47792
4827,28,2000-06-16,Jesus' Son,2500000,1282084,1687548,-812452,6,405464,2000,-32.49808
4828,29,2005-05-27,Saving Face,2500000,1187266,1269705,-1230295,5,82439,2005,-49.2118
4829,30,2008-06-20,Brick Lane,2500000,1094998,3838486,1338486,6,2743488,2008,53.539440000000006
4830,31,2013-03-01,The Lost Medallion: The Adventures of Billy Stone,2500000,549632,549632,-1950368,3,0,2013,-78.01472000000001
4831,32,2003-09-26,My Life Without Me,2500000,432360,12267275,9767275,9,11834915,2003,390.691
4832,33,2006-03-31,Marilyn Hotchkiss' Ballroom Dancing and Charm School,2500000,349132,497195,-2002805,3,148063,2006,-80.1122
4833,34,2011-04-01,Super,2500000,327716,593933,-1906067,4,266217,2011,-76.24268
4834,35,2008-11-14,Fuel,2500000,174255,174255,-2325745,11,0,2008,-93.0298
4835,36,2010-04-09,Valley of the Hearts Delight,2500000,118666,118666,-2381334,4,0,2010,-95.25336
4836,37,2008-10-31,The Other End of the Line,2500000,115504,507446,-1992554,10,391942,2008,-79.70216
4837,38,2010-06-18,8: The Mormon Proposition,2500000,100280,100280,-2399720,6,0,2010,-95.9888
4838,39,2009-04-17,Sleep Dealer,2500000,80136,108907,-2391093,4,28771,2009,-95.64372
4839,40,2007-08-24,Eye of the Dolphin,2500000,72210,72260,-2427740,8,50,2007,-97.1096
4840,41,2013-08-16,Underdogs,2500000,35017,1392649,-1107351,8,1357632,2013,-44.29404
4841,42,2000-09-08,Anatomie,2500000,9598,9598,-2490402,9,0,2000,-99.61608
4842,43,2009-12-31,The Calling,2500000,0,0,-2500000,12,0,2009,-100.0
4843,44,2013-06-21,Alien Uprising,2500000,0,0,-2500000,6,0,2013,-100.0
4844,45,2010-12-31,Christmas Mail,2500000,0,0,-2500000,12,0,2010,-100.0
4845,46,2015-07-03,Stung,2500000,0,0,-2500000,7,0,2015,-100.0
4846,47,2017-09-01,Sky Sharks,2500000,0,0,-2500000,9,0,2017,-100.0
4847,48,2015-10-13,8 Days,2500000,0,0,-2500000,10,0,2015,-100.0
4848,49,2016-09-02,Antibirth,2500000,0,0,-2500000,9,0,2016,-100.0
4849,50,2016-02-02,The Rise of the Krays,2500000,0,0,-2500000,2,0,2016,-100.0
4850,51,2014-12-31,Not Safe For Work,2500000,0,0,-2500000,12,0,2014,-100.0
4851,52,2011-05-13,Go For It!,2450000,180237,182358,-2267642,5,2121,2011,-92.55681632653061
4852,53,1996-10-16,Get on the Bus,2400000,5691854,5691854,3291854,10,0,1996,137.16058333333334
4853,54,2007-01-05,Thr3e,2400000,1008849,1420418,-979582,1,411569,2007,-40.815916666666666
4854,55,2006-09-01,Idiocracy,2400000,444093,500296,-1899704,9,56203,2006,-79.15433333333334
4855,56,2009-12-31,NiktÃ©,2400000,0,1333891,-1066109,12,1333891,2009,-44.42120833333333
4856,57,2014-11-14,Always Woodstock,2400000,0,0,-2400000,11,0,2014,-100.0
4857,58,2007-07-25,This is England,2380000,327919,8739576,6359576,7,8411657,2007,267.2090756302521
4858,59,1944-06-27,Bathing Beauty,2361000,3500000,3500000,1139000,6,0,1944,48.24227022448115
4859,60,2015-03-20,Do You Believe?,2300000,12985600,14304931,12004931,3,1319331,2015,521.9535217391305
4860,61,1951-07-17,Show Boat,2300000,11000000,11000000,8700000,7,0,1951,378.2608695652174
4861,62,1998-05-01,"Dancer, Texas Pop. 81",2300000,574838,574838,-1725162,5,0,1998,-75.00704347826087
4862,63,2014-09-05,Frontera,2300000,59696,59696,-2240304,9,0,2014,-97.40452173913043
4863,64,2011-08-26,Redemption Road,2300000,29384,29384,-2270616,8,0,2011,-98.72243478260869
4864,65,2015-04-15,The Toxic Avenger Part II,2300000,0,0,-2300000,4,0,2015,-100.0
4865,66,2016-01-19,Eden,2300000,0,0,-2300000,1,0,2016,-100.0
4866,67,1987-06-19,The Brave Little Toaster,2300000,0,0,-2300000,6,0,1987,-100.0
4867,68,1940-02-09,Pinocchio,2289247,84300000,84300000,82010753,2,0,1940,3582.4335687673715
4868,69,1940-11-13,Fantasia,2280000,83320000,83320000,81040000,11,0,1940,3554.385964912281
4869,70,1982-08-13,Friday the 13th Part 3,2250000,36690067,36690067,34440067,8,0,1982,1530.6696444444444
4870,71,1971-10-09,The French Connection,2200000,41158757,41158757,38958757,10,0,1971,1770.8525909090908
4871,72,1985-03-22,Friday the 13th Part V: A New Beginning,2200000,21930418,21930418,19730418,3,0,1985,896.8371818181819
4872,73,2007-02-09,The Last Sin Eater,2200000,388390,388390,-1811610,2,0,2007,-82.34590909090909
4873,74,2008-12-31,Impact Point,2200000,0,0,-2200000,12,0,2008,-100.0
4874,75,1945-05-03,The Valley of Decision,2160000,9132000,9132000,6972000,5,0,1945,322.77777777777777
4875,76,2005-12-31,Chicken Tikka Masala,2160000,0,37865,-2122135,12,37865,2005,-98.24699074074074
4876,77,2008-10-07,Jack Brooks: Monster Slayer,2150000,0,0,-2150000,10,0,2008,-100.0
4877,78,1946-11-21,The Best Years of Our Lives,2100000,23600000,23600000,21500000,11,0,1946,1023.8095238095237
4878,79,2001-07-13,Bully,2100000,881824,1381824,-718176,7,500000,2001,-34.19885714285714
4879,80,2002-05-29,Elling,2100000,313436,313436,-1786564,5,0,2002,-85.07447619047619
4880,81,2016-10-16,Mi America,2100000,3330,3330,-2096670,10,0,2016,-99.84142857142857
4881,82,2009-07-14,[Rec],2100000,0,23266821,21166821,7,23266821,2009,1007.9438571428572
4882,83,2012-12-31,Infected,2100000,0,0,-2100000,12,0,2012,-100.0
4883,84,2010-12-31,Lies in Plain Sight,2100000,0,0,-2100000,12,0,2010,-100.0
4884,85,2015-10-06,The Timber,2100000,0,0,-2100000,10,0,2015,-100.0
4885,86,2016-01-19,Sharkskin,2100000,0,0,-2100000,1,0,2016,-100.0
4886,87,2011-09-30,Courageous,2000000,34522221,35185884,33185884,9,663663,2011,1659.2942
4887,88,1964-04-08,From Russia With Love,2000000,24800000,78900000,76900000,4,54100000,1964,3845.0000000000005
4888,89,1982-05-21,Mad Max 2: The Road Warrior,2000000,24600832,24600832,22600832,5,0,1982,1130.0416
4889,90,1946-08-15,Notorious,2000000,24464742,24464742,22464742,8,0,1946,1123.2371
4890,91,1967-08-02,In the Heat of the Night,2000000,24379978,24407647,22407647,8,27669,1967,1120.38235
4891,92,1973-12-17,Sleeper,2000000,18344729,18344729,16344729,12,0,1973,817.2364500000001
4892,93,1972-08-11,Everything You Always Wanted to Know,2000000,18016290,18016290,16016290,8,0,1972,800.8145000000001
4893,94,2015-03-13,It Follows,2000000,14674077,23250755,21250755,3,8576678,2015,1062.5377500000002
4894,95,2018-07-13,Eighth Grade,2000000,13539710,14341016,12341016,7,801306,2018,617.0508
4895,96,1962-12-25,To Kill A Mockingbird,2000000,13129846,13129846,11129846,12,0,1962,556.4923
4896,97,2012-03-09,Silent House,2000000,12739737,16610760,14610760,3,3871023,2012,730.538
4897,98,1999-10-08,Boys Don't Cry,2000000,11540607,20741000,18741000,10,9200393,1999,937.05
4898,99,2007-02-09,Das Leben der Anderen,2000000,11284657,81197047,79197047,2,69912390,2007,3959.85235
4899,100,2016-04-08,Hardcore Henry,2000000,9252038,17187434,15187434,4,7935396,2016,759.3717
4900,1,1962-06-13,Lolita,2000000,9250000,9250000,7250000,6,0,1962,362.5
4901,2,1940-08-30,Boom Town,2000000,9172000,9172000,7172000,8,0,1940,358.59999999999997
4902,3,1947-11-11,Gentleman's Agreement,2000000,7800000,7800000,5800000,11,0,1947,290.0
4903,4,1961-09-25,The Hustler,2000000,7600000,7600000,5600000,9,0,1961,280.0
4904,5,1986-12-31,Witchboard,2000000,7369373,7369373,5369373,12,0,1986,268.46865
4905,6,2003-11-26,Les Triplettes de Belleville,2000000,7301288,17403168,15403168,11,10101880,2003,770.1584
4906,7,1998-06-26,Smoke Signals,2000000,6719300,7756617,5756617,6,1037317,1998,287.83085
4907,8,2010-06-11,Winter's Bone,2000000,6531503,16131551,14131551,6,9600048,2010,706.57755
4908,9,2014-10-10,Meet the Mormons,2000000,6047363,6049171,4049171,10,1808,2014,202.45855
4909,10,2003-08-15,American Splendor,2000000,6003587,8685632,6685632,8,2682045,2003,334.2816
4910,11,2017-10-06,The Florida Project,2000000,5904366,11295324,9295324,10,5390958,2017,464.7662
4911,12,2017-08-25,All Saints,2000000,5802208,5941994,3941994,8,139786,2017,197.0997
4912,13,2004-07-02,Before Sunset,2000000,5792822,11217346,9217346,7,5424524,2004,460.86729999999994
4913,14,2001-03-30,Amores Perros,2000000,5383834,20883834,18883834,3,15500000,2001,944.1917
4914,15,2003-08-20,Thirteen,2000000,4601043,9505996,7505996,8,4904953,2003,375.2998
4915,16,2004-01-23,Touching the Void,2000000,4593598,15396525,13396525,1,10802927,2004,669.8262500000001
4916,17,2010-10-08,Inside Job,2000000,4311834,7799257,5799257,10,3487423,2010,289.96285
4917,18,1938-05-24,Alexander's Ragtime Band,2000000,4000000,4000000,2000000,5,0,1938,100.0
4918,19,2005-06-17,Me and You and Everyone We Know,2000000,3885134,9615464,7615464,6,5730330,2005,380.77320000000003
4919,20,2015-08-28,We Are Your Friends,2000000,3591417,10153415,8153415,8,6561998,2015,407.67075000000006
4920,21,2006-11-10,Harsh Times,2000000,3337931,6225304,4225304,11,2887373,2006,211.26520000000002
4921,22,2000-03-03,Ghost Dog: The Way of the Samurai,2000000,3330230,10672492,8672492,3,7342262,2000,433.6246
4922,23,2015-09-18,Captive,2000000,2583301,2791973,791973,9,208672,2015,39.59865
4923,24,2002-08-02,Full Frontal,2000000,2512846,3438804,1438804,8,925958,2002,71.9402
4924,25,2018-06-08,Hearts Beat Loud,2000000,2386254,2420962,420962,6,34708,2018,21.0481
4925,26,2017-01-20,The Resurrection of Gavin Stone,2000000,2303792,2303792,303792,1,0,2017,15.1896
4926,27,2008-12-25,Waltz with Bashir,2000000,2283849,13912289,11912289,12,11628440,2008,595.6144499999999
4927,28,2006-06-28,Strangers with Candy,2000000,2072645,2077844,77844,6,5199,2006,3.8922
4928,29,1992-03-01,Night on Earth,2000000,2015000,2022893,22893,3,7893,1992,1.14465
4929,30,1993-01-29,Nemesis,2000000,2001124,2001124,1124,1,0,1993,0.0562
4930,31,2006-10-04,Shortbus,2000000,1985292,1985292,-14708,10,0,2006,-0.7354
4931,32,2008-05-02,Son of Rambow: A Home Movie,2000000,1785505,11263263,9263263,5,9477758,2008,463.16315000000003
4932,33,2003-09-12,"The Book of Mormon Movie, Volume 1: The Journey",2000000,1660865,1660865,-339135,9,0,2003,-16.95675
4933,34,2000-05-12,Hamlet,2000000,1577287,2419669,419669,5,842382,2000,20.98345
4934,35,2015-08-07,The Diary of a Teenage Girl,2000000,1477002,2279959,279959,8,802957,2015,13.997950000000001
4935,36,2007-07-27,No End In Sight,2000000,1433319,1433319,-566681,7,0,2007,-28.334049999999998
4936,37,2014-04-25,Locke,2000000,1370646,2088390,88390,4,717744,2014,4.4195
4937,38,1999-04-30,Get Real,2000000,1152411,1152411,-847589,4,0,1999,-42.37945
4938,39,2007-09-07,In the Shadow of the Moon,2000000,1134358,2175587,175587,9,1041229,2007,8.779349999999999
4939,40,2011-04-08,Meek's Cutoff,2000000,977772,1869928,-130072,4,892156,2011,-6.5036
4940,41,2014-11-28,The Babadook,2000000,950792,7482387,5482387,11,6531595,2014,274.11935
4941,42,2005-02-11,Inside Deep Throat,2000000,691880,691880,-1308120,2,0,2005,-65.40599999999999
4942,43,2001-09-28,Dinner Rush,2000000,638227,1075504,-924496,9,437277,2001,-46.2248
4943,44,2010-09-24,The Virginity Hit,2000000,636706,636706,-1363294,9,0,2010,-68.1647
4944,45,1998-05-15,Clockwatchers,2000000,537948,539961,-1460039,5,2013,1998,-73.00195000000001
4945,46,1985-11-06,Subway,2000000,390659,1663296,-336704,11,1272637,1985,-16.8352
4946,47,2005-04-15,House of D,2000000,388532,466106,-1533894,4,77574,2005,-76.69470000000001
4947,48,2008-01-18,Teeth,2000000,347578,2350641,350641,1,2003063,2008,17.532049999999998
4948,49,1996-07-26,Stonewall,2000000,304602,304602,-1695398,7,0,1996,-84.76989999999999
4949,50,2006-09-08,Sherrybaby,2000000,199176,759504,-1240496,9,560328,2006,-62.0248
4950,51,2015-02-13,The Last Five Years,2000000,147299,205298,-1794702,2,57999,2015,-89.7351
4951,52,1998-09-18,Six-String Samurai,2000000,134624,134624,-1865376,9,0,1998,-93.2688
4952,53,2000-05-26,Hum to Mohabbt Karega,2000000,121807,121807,-1878193,5,0,2000,-93.90965
4953,54,2005-04-15,It's All Gone Pete Tong,2000000,120620,2226603,226603,4,2105983,2005,11.33015
4954,55,2010-01-29,Saint John of Las Vegas,2000000,102645,102645,-1897355,1,0,2010,-94.86775
4955,56,1998-04-15,24 7: Twenty Four Seven,2000000,72544,72544,-1927456,4,0,1998,-96.3728
4956,57,2014-09-19,Pump,2000000,72277,72277,-1927723,9,0,2014,-96.38615
4957,58,2008-10-24,Roadside Romeo,2000000,55202,2046090,46090,10,1990888,2008,2.3045
4958,59,2001-05-04,Eureka,2000000,49388,76654,-1923346,5,27266,2001,-96.1673
4959,60,2015-04-07,Lost River,2000000,45431,2009644,9644,4,1964213,2015,0.48219999999999996
4960,61,2003-07-18,This Thing of Ours,2000000,37227,37227,-1962773,7,0,2003,-98.13865
4961,62,2015-10-09,Knock Knock,2000000,36336,6328516,4328516,10,6292180,2015,216.42579999999998
4962,63,2017-02-03,Growing up Smith,2000000,35312,35312,-1964688,2,0,2017,-98.2344
4963,64,2009-03-20,Super Capers,2000000,30955,30955,-1969045,3,0,2009,-98.45224999999999
4964,65,1993-01-01,Return of the Living Dead 3,2000000,21000,21000,-1979000,1,0,1993,-98.95
4965,66,2009-11-20,The Missing Person,2000000,17896,17896,-1982104,11,0,2009,-99.10520000000001
4966,67,2012-10-19,The First Time,2000000,17061,17061,-1982939,10,0,2012,-99.14695
4967,68,2006-02-10,London,2000000,12667,12667,-1987333,2,0,2006,-99.36665
4968,69,2010-08-27,Circle,2000000,10024,10024,-1989976,8,0,2010,-99.4988
4969,70,2008-10-31,Eden Lake,2000000,7321,4294373,2294373,10,4287052,2008,114.71865000000001
4970,71,2010-06-11,Jerusalema,2000000,7294,10679,-1989321,6,3385,2010,-99.46605
4971,72,2006-06-23,Say Uncle,2000000,5361,5361,-1994639,6,0,2006,-99.73195
4972,73,2013-09-13,Plush,2000000,3080,28864,-1971136,9,25784,2013,-98.5568
4973,74,2012-10-26,The Ghastly Love of Johnny X,2000000,2436,2436,-1997564,10,0,2012,-99.87819999999999
4974,75,2009-12-29,Lesbian Vampire Killers,2000000,0,3620902,1620902,12,3620902,2009,81.0451
4975,76,2011-09-09,Grave Encounters,2000000,0,2151887,151887,9,2151887,2011,7.5943499999999995
4976,77,2015-10-23,Bone Tomahawk,2000000,0,475846,-1524154,10,475846,2015,-76.2077
4977,78,2004-12-10,Freeze Frame,2000000,0,105377,-1894623,12,105377,2004,-94.73115
4978,79,2013-04-01,Stitches,2000000,0,63555,-1936445,4,63555,2013,-96.82225
4979,80,2015-12-31,"To Be Frank, Sinatra at 100",2000000,0,926,-1999074,12,926,2015,-99.9537
4980,81,1971-04-28,Bananas,2000000,0,0,-2000000,4,0,1971,-100.0
4981,82,2009-12-31,Nine Dead,2000000,0,0,-2000000,12,0,2009,-100.0
4982,83,2008-10-14,No Man's Land: The Rise of Reeker,2000000,0,0,-2000000,10,0,2008,-100.0
4983,84,2007-07-07,Rockaway,2000000,0,0,-2000000,7,0,2007,-100.0
4984,85,1927-08-12,Wings,2000000,0,0,-2000000,8,0,1927,-100.0
4985,86,2015-03-17,The Lady from Shanghai,2000000,0,0,-2000000,3,0,2015,-100.0
4986,87,2013-03-19,Straight A's,2000000,0,0,-2000000,3,0,2013,-100.0
4987,88,2012-03-30,The Legend of Hellâs Gate: An American Conspiracy,2000000,0,0,-2000000,3,0,2012,-100.0
4988,89,2012-12-31,Highway,2000000,0,0,-2000000,12,0,2012,-100.0
4989,90,2013-02-08,Small Apartments,2000000,0,0,-2000000,2,0,2013,-100.0
4990,91,2013-07-09,Coffee Town,2000000,0,0,-2000000,7,0,2013,-100.0
4991,92,2014-12-31,Lucky Dog,2000000,0,0,-2000000,12,0,2014,-100.0
4992,93,2001-12-31,Pendulum,2000000,0,0,-2000000,12,0,2001,-100.0
4993,94,1966-10-16,A Funny Thing Happened on the Way to the Forum,2000000,0,0,-2000000,10,0,1966,-100.0
4994,95,2008-09-23,Slacker Uprising,2000000,0,0,-2000000,9,0,2008,-100.0
4995,96,2015-03-20,The Walking Deceased,2000000,0,0,-2000000,3,0,2015,-100.0
4996,97,2011-12-31,True Bromance,2000000,0,0,-2000000,12,0,2011,-100.0
4997,98,2015-08-21,The Curse of Downers Grove,2000000,0,0,-2000000,8,0,2015,-100.0
4998,99,2015-12-31,Wind Walkers,2000000,0,0,-2000000,12,0,2015,-100.0
4999,100,2016-07-08,The Dog Lover,2000000,0,0,-2000000,7,0,2016,-100.0
5000,1,2015-12-01,Shark Lake,2000000,0,0,-2000000,12,0,2015,-100.0
5001,2,2010-09-24,Buried,1987650,1044143,21270290,19282640,9,20226147,2010,970.1225064774986
5002,3,2015-04-21,The Marine 4,1950000,0,0,-1950000,4,0,2015,-100.0
5003,4,1987-05-08,River's Edge,1900000,4600000,4600000,2700000,5,0,1987,142.10526315789474
5004,5,2008-07-25,Man on Wire,1900000,2962242,5617067,3717067,7,2654825,2008,195.6351052631579
5005,6,2010-10-08,Nowhere Boy,1900000,1445366,7785229,5885229,10,6339863,2010,309.7488947368421
5006,7,2003-07-11,Northfork,1900000,1420578,1445140,-454860,7,24562,2003,-23.94
5007,8,2015-04-24,Brotherly Love,1900000,478595,478595,-1421405,4,0,2015,-74.81078947368421
5008,9,2011-06-03,Submarine,1900000,467602,4581937,2681937,6,4114335,2011,141.15457894736844
5009,10,2010-04-09,The Square,1900000,406216,740932,-1159068,4,334716,2010,-61.00357894736842
5010,11,2013-02-08,ABCD (Any Body Can Dance),1900000,222098,10137234,8237234,2,9915136,2013,433.53863157894733
5011,12,2007-06-29,Chacun sa nuit,1900000,18435,139317,-1760683,6,120882,2007,-92.66752631578947
5012,13,2013-07-26,Stranded,1900000,0,285593,-1614407,7,285593,2013,-84.96878947368421
5013,14,2015-12-31,Vaalu,1900000,0,12444,-1887556,12,12444,2015,-99.34505263157895
5014,15,2010-08-27,The Last Exorcism,1800000,41034350,70165900,68365900,8,29131550,2010,3798.105555555556
5015,16,1976-11-16,Carrie,1800000,25878153,25878153,24078153,11,0,1976,1337.6751666666667
5016,17,1984-11-09,A Nightmare on Elm Street,1800000,25504513,25504513,23704513,11,0,1984,1316.9173888888888
5017,18,2012-06-27,Beasts of the Southern Wild,1800000,12795746,23265132,21465132,6,10469386,2012,1192.5073333333335
5018,19,1964-01-29,Dr. Strangelove,1800000,9164370,9230678,7430678,1,66308,1964,412.81544444444444
5019,20,1973-01-01,Battle for the Planet of the Apes,1800000,8800000,8800000,7000000,1,0,1973,388.88888888888886
5020,21,1951-09-18,A Streetcar Named Desire,1800000,8000000,8000000,6200000,9,0,1951,344.44444444444446
5021,22,1968-08-03,Hang 'em High,1800000,6800000,6800000,5000000,8,0,1968,277.77777777777777
5022,23,2002-11-15,El crimen de padre Amaro,1800000,5719000,5719000,3919000,11,0,2002,217.72222222222223
5023,24,2001-06-15,Songcatcher,1800000,3050934,3050934,1250934,6,0,2001,69.49633333333334
5024,25,2011-08-23,Higher Ground,1800000,841056,842693,-957307,8,1637,2011,-53.183722222222215
5025,26,2011-04-22,POM Wonderful Presents: The Greatest Movie Ever Sold,1800000,638476,783733,-1016267,4,145257,2011,-56.459277777777785
5026,27,2005-01-07,Travellers and Magicians,1800000,506793,1322161,-477839,1,815368,2005,-26.546611111111112
5027,28,1993-01-01,Ed and his Dead Mother,1800000,673,673,-1799327,1,0,1993,-99.96261111111112
5028,29,2009-12-31,Deadline,1800000,0,0,-1800000,12,0,2009,-100.0
5029,30,2007-03-13,Sublime,1800000,0,0,-1800000,3,0,2007,-100.0
5030,31,2012-02-03,Dysfunctional Friends,1800000,0,0,-1800000,2,0,2012,-100.0
5031,32,2013-12-31,Independence Daysaster,1800000,0,0,-1800000,12,0,2013,-100.0
5032,33,2014-03-11,Against the Wild,1800000,0,0,-1800000,3,0,2014,-100.0
5033,34,2015-10-20,Beginnerâs Guide to Sex,1800000,0,0,-1800000,10,0,2015,-100.0
5034,35,1999-06-18,Lola rennt,1750000,7267324,22879194,21129194,6,15611870,1999,1207.3825142857143
5035,36,2003-02-07,May,1750000,145540,634803,-1115197,2,489263,2003,-63.725542857142855
5036,37,2010-10-08,I Spit on Your Grave,1750000,93051,1278471,-471529,10,1185420,2010,-26.944514285714288
5037,38,2019-04-23,Living Dark: The Story of Ted the Caver,1750000,0,0,-1750000,4,0,2019,-100.0
5038,39,2001-11-23,In the Bedroom,1700000,35930604,42137871,40437871,11,6207267,2001,2378.698294117647
5039,40,2008-03-19,La misma luna,1700000,12590147,23271741,21571741,3,10681594,2008,1268.9259411764706
5040,41,1972-06-30,Conquest of the Planet of the Apes,1700000,9700000,9700000,8000000,6,0,1972,470.5882352941177
5041,42,2014-02-28,The Lunchbox,1700000,4231500,12231500,10531500,2,8000000,2014,619.5
5042,43,2013-10-04,Grace Unplugged,1700000,2507159,2507159,807159,10,0,2013,47.47994117647059
5043,44,1999-10-01,"Happy, Texas",1700000,2039192,2891228,1191228,10,852036,1999,70.07223529411765
5044,45,2015-12-18,Saul fia,1700000,1777043,9696537,7996537,12,7919494,2015,470.3845294117647
5045,46,2005-06-17,My Summer of Love,1700000,1000915,4727375,3027375,6,3726460,2005,178.08088235294116
5046,47,2005-06-24,Yes,1700000,396035,661221,-1038779,6,265186,2005,-61.104647058823524
5047,48,2019-02-01,Braid,1660000,0,80745,-1579255,2,80745,2019,-95.13584337349398
5048,49,1953-08-05,From Here to Eternity,1650000,30500000,30500000,28850000,8,0,1953,1748.4848484848485
5049,50,1938-09-01,You Can't Take It With You,1644000,4000000,4000000,2356000,9,0,1938,143.30900243309003
5050,51,1999-04-09,Foolish,1600000,6026908,6026908,4426908,4,0,1999,276.68175
5051,52,1949-07-26,She Wore a Yellow Ribbon,1600000,5400000,5400000,3800000,7,0,1949,237.5
5052,53,1974-04-07,The Conversation,1600000,4420000,4420000,2820000,4,0,1974,176.25
5053,54,2010-10-15,N-Secure,1600000,2595644,2595644,995644,10,0,2010,62.22775
5054,55,2008-02-01,Sukkar banat,1600000,1060591,14253760,12653760,2,13193169,2008,790.86
5055,56,1989-12-31,Out of the Dark,1600000,419428,419428,-1180572,12,0,1989,-73.78575000000001
5056,57,2006-01-27,Bubble,1600000,145382,145382,-1454618,1,0,2006,-90.913625
5057,58,2005-09-23,Dil Jo Bhi Kahey...,1600000,129319,129319,-1470681,9,0,2005,-91.9175625
5058,59,1999-01-15,Mississippi Mermaid,1600000,27795,2627795,1027795,1,2600000,1999,64.2371875
5059,60,2014-09-26,Two Night Stand,1600000,15600,868081,-731919,9,852481,2014,-45.7449375
5060,61,2005-11-04,I Love Your Work,1600000,3264,3264,-1596736,11,0,2005,-99.79599999999999
5061,62,1955-08-05,The Kingâs Thief,1577000,0,0,-1577000,8,0,1955,-100.0
5062,63,2011-04-01,Insidious,1500000,54009150,99870886,98370886,4,45861736,2011,6558.059066666667
5063,64,2016-10-21,Moonlight,1500000,27854931,65245512,63745512,10,37390581,2016,4249.7008000000005
5064,65,2003-09-12,Cabin Fever,1500000,21158188,30351664,28851664,9,9193476,2003,1923.4442666666666
5065,66,2007-05-02,Waitress,1500000,19097550,22217183,20717183,5,3119633,2007,1381.1455333333333
5066,67,1989-09-08,Kickboxer,1500000,14533681,14533681,13033681,9,0,1989,868.9120666666665
5067,68,1988-02-26,Bloodsport,1500000,11806119,11806119,10306119,2,0,1988,687.0745999999999
5068,69,1939-10-17,Mr. Smith Goes To Washington,1500000,9000000,9000000,7500000,10,0,1939,500.0
5069,70,2018-03-23,Unsane,1500000,7690044,14244931,12744931,3,6554887,2018,849.6620666666666
5070,71,1995-07-21,Kids,1500000,7412216,20412216,18912216,7,13000000,1995,1260.8144
5071,72,2005-10-05,The Squid and the Whale,1500000,7372734,11191423,9691423,10,3818689,2005,646.0948666666667
5072,73,2002-03-13,Kissing Jessica Stein,1500000,7025722,9345061,7845061,3,2319339,2002,523.0040666666666
5073,74,1945-10-31,Spellbound,1500000,7000000,7000000,5500000,10,0,1945,366.66666666666663
5074,75,1979-04-20,Dawn of the Dead,1500000,5100000,55000000,53500000,4,49900000,1979,3566.6666666666665
5075,76,1994-09-23,Exotica,1500000,5046118,5046118,3546118,9,0,1994,236.40786666666668
5076,77,2013-07-26,The To Do List,1500000,3491669,4128828,2628828,7,637159,2013,175.2552
5077,78,2013-02-01,The Gatekeepers,1500000,2408553,2592308,1092308,2,183755,2013,72.82053333333334
5078,79,1998-06-26,Buffalo '66,1500000,2380606,2380606,880606,6,0,1998,58.70706666666666
5079,80,1984-03-02,Repo Man,1500000,2300000,2300000,800000,3,0,1984,53.333333333333336
5080,81,2016-10-21,Iâm Not Ashamed,1500000,2082980,2082980,582980,10,0,2016,38.86533333333333
5081,82,1985-01-18,Blood Simple,1500000,1690913,2730877,1230877,1,1039964,1985,82.05846666666666
5082,83,2002-04-19,Nueve Reinas,1500000,1222889,12412889,10912889,4,11190000,2002,727.5259333333333
5083,84,2013-04-19,The Lords of Salem,1500000,1165881,1541131,41131,4,375250,2013,2.7420666666666667
5084,85,2016-10-21,31,1500000,779820,922727,-577273,10,142907,2016,-38.48486666666667
5085,86,2005-03-25,The Ballad of Jack and Rose,1500000,712294,1126258,-373742,3,413964,2005,-24.916133333333335
5086,87,2016-04-22,Unsullied,1500000,510957,510957,-989043,4,0,2016,-65.9362
5087,88,1994-08-31,Killing Zoe,1500000,418953,418953,-1081047,8,0,1994,-72.0698
5088,89,2002-05-17,The Believer,1500000,406035,1840248,340248,5,1434213,2002,22.6832
5089,90,2008-03-07,Snow Angels,1500000,402858,414404,-1085596,3,11546,2008,-72.37306666666666
5090,91,2001-08-10,Session 9,1500000,378176,1619602,119602,8,1241426,2001,7.973466666666666
5091,92,2011-02-11,MOOZ-lum,1500000,362239,372239,-1127761,2,10000,2011,-75.18406666666667
5092,93,2007-09-05,I Want Someone To Eat Cheese With,1500000,194568,194568,-1305432,9,0,2007,-87.02879999999999
5093,94,2011-08-19,Amigo,1500000,184705,184705,-1315295,8,0,2011,-87.68633333333334
5094,95,2007-09-07,Hatchet,1500000,175281,240396,-1259604,9,65115,2007,-83.9736
5095,96,2008-10-31,My Name is Bruce,1500000,173066,173066,-1326934,10,0,2008,-88.46226666666666
5096,97,2010-08-06,The Disappearance of Alice Creed,1500000,166980,1605139,105139,8,1438159,2010,7.009266666666666
5097,98,1936-02-05,Modern Times,1500000,163245,199747,-1300253,2,36502,1936,-86.68353333333333
5098,99,2007-05-11,The Salon,1500000,139084,139084,-1360916,5,0,2007,-90.72773333333333
5099,100,2013-10-25,The Square,1500000,124244,176262,-1323738,10,52018,2013,-88.2492
5100,1,2002-03-22,Stolen Summer,1500000,119841,119841,-1380159,3,0,2002,-92.0106
5101,2,2015-03-06,Road Hard,1500000,113169,113169,-1386831,3,0,2015,-92.4554
5102,3,2005-09-28,Forty Shades of Blue,1500000,75828,172569,-1327431,9,96741,2005,-88.4954
5103,4,2009-10-09,Trucker,1500000,52429,52429,-1447571,10,0,2009,-96.50473333333333
5104,5,2009-05-29,Pontypool,1500000,3865,31916,-1468084,5,28051,2009,-97.87226666666666
5105,6,2015-09-28,"Me, You and Five Bucks",1500000,2105,2105,-1497895,9,0,2015,-99.85966666666667
5106,7,2014-10-17,Housebound,1500000,0,236863,-1263137,10,236863,2014,-84.20913333333333
5107,8,2018-07-20,Teefa in Trouble,1500000,0,98806,-1401194,7,98806,2018,-93.41293333333334
5108,9,2005-11-04,Wal-Mart: The High Cost of Low Price,1500000,0,58692,-1441308,11,58692,2005,-96.0872
5109,10,2014-04-17,Closer to the Moon,1500000,0,5396,-1494604,4,5396,2014,-99.64026666666666
5110,11,2006-03-17,Fetching Cody,1500000,0,0,-1500000,3,0,2006,-100.0
5111,12,2011-06-03,The Lion of Judah,1500000,0,0,-1500000,6,0,2011,-100.0
5112,13,2014-11-11,Once Upon a Time in Queens,1500000,0,0,-1500000,11,0,2014,-100.0
5113,14,2015-02-13,Girlhouse,1500000,0,0,-1500000,2,0,2015,-100.0
5114,15,2015-05-26,Mutant World,1500000,0,0,-1500000,5,0,2015,-100.0
5115,16,2015-11-20,#Horror,1500000,0,0,-1500000,11,0,2015,-100.0
5116,17,2015-09-08,Checkmate,1500000,0,0,-1500000,9,0,2015,-100.0
5117,18,1937-12-21,Snow White and the Seven Dwarfs,1488000,184925486,184925486,183437486,12,0,1937,12327.78803763441
5118,19,1968-01-01,Shalako,1455000,2620000,2620000,1165000,1,0,1968,80.06872852233677
5119,20,2018-11-30,Werk ohne Autor,1400000,1303747,4331152,2931152,11,3027405,2018,209.368
5120,21,2015-11-20,Mustang,1400000,845464,5552584,4152584,11,4707120,2015,296.61314285714286
5121,22,2005-04-29,The Holy Girl,1400000,304124,1261792,-138208,4,957668,2005,-9.872
5122,23,2014-10-03,La chambre bleue,1400000,260441,1945420,545420,10,1684979,2014,38.95857142857143
5123,24,2004-09-17,Incident at Loch Ness,1400000,36830,56073,-1343927,9,19243,2004,-95.99478571428571
5124,25,2013-04-05,Eddie: The Sleepwalking Cannibal,1400000,1632,1632,-1398368,4,0,2013,-99.88342857142857
5125,26,2010-05-01,My Girlfriend's Boyfriend,1400000,0,0,-1400000,5,0,2010,-100.0
5126,27,2014-12-31,Kurmanjan datka,1400000,0,0,-1400000,12,0,2014,-100.0
5127,28,2014-12-31,House at the End of the Drive,1400000,0,0,-1400000,12,0,2014,-100.0
5128,29,1966-07-06,Batman - The Movie,1377800,0,0,-1377800,7,0,1966,-100.0
5129,30,1999-03-05,"Lock, Stock and Two Smoking Barrels",1350000,3897569,28356188,27006188,3,24458619,1999,2000.4583703703706
5130,31,1983-08-19,The Ballad of Gregorio Cortez,1305000,909000,909000,-396000,8,0,1983,-30.344827586206897
5131,32,1936-06-26,San Francisco,1300000,2868000,5273000,3973000,6,2405000,1936,305.61538461538464
5132,33,1998-10-09,Festen,1300000,1647780,1647780,347780,10,0,1998,26.752307692307692
5133,34,1996-10-11,Trees Lounge,1300000,749741,749741,-550259,10,0,1996,-42.327615384615385
5134,35,2009-05-22,The Girlfriend Experience,1300000,695840,1005840,-294160,5,310000,2009,-22.627692307692307
5135,36,2007-03-23,Journey from the Fall,1300000,635305,635305,-664695,3,0,2007,-51.130384615384614
5136,37,2000-05-05,The Basket,1300000,609042,609042,-690958,5,0,2000,-53.150615384615385
5137,38,2015-01-30,Above and Beyond,1300000,288751,288751,-1011249,1,0,2015,-77.78838461538462
5138,39,1985-03-15,Def-Con 4,1300000,210904,210904,-1089096,3,0,1985,-83.77661538461538
5139,40,2005-12-09,Neal n' Nikki,1300000,100358,329621,-970379,12,229263,2005,-74.64453846153846
5140,41,2003-12-19,The Hebrew Hammer,1300000,77755,90213,-1209787,12,12458,2003,-93.06053846153847
5141,42,2014-06-13,Los insolitos peces gato,1300000,11278,54665,-1245335,6,43387,2014,-95.795
5142,43,2006-04-07,Simon,1300000,4055,1738663,438663,4,1734608,2006,33.743307692307695
5143,44,2011-05-24,Forget Me Not,1300000,0,13465,-1286535,5,13465,2011,-98.96423076923077
5144,45,2010-06-08,The 41-Year-Old Virgin Who Knocked Up Sarah Marshall and Felt Superbad About It,1300000,0,0,-1300000,6,0,2010,-100.0
5145,46,2015-06-26,The Algerian,1300000,0,0,-1300000,6,0,2015,-100.0
5146,47,1940-03-21,Rebecca,1288000,6000000,6002370,4714370,3,2370,1940,366.0225155279503
5147,48,1981-04-30,Friday the 13th Part 2,1250000,21722776,21722776,20472776,4,0,1981,1637.8220800000001
5148,49,1945-11-29,The Lost Weekend,1250000,11000000,11000000,9750000,11,0,1945,780.0
5149,50,1984-08-31,C.H.U.D.,1250000,4700000,4700000,3450000,8,0,1984,276.0
5150,51,2014-10-17,Dear White People,1250000,4404154,5403771,4153771,10,999617,2014,332.30168
5151,52,2013-04-19,Filly Brown,1250000,2850357,2940411,1690411,4,90054,2013,135.23288
5152,53,1953-01-21,Niagara,1250000,2500000,2500000,1250000,1,0,1953,100.0
5153,54,2016-12-31,Bodom,1250000,0,726460,-523540,12,726460,2016,-41.883199999999995
5154,55,1941-10-28,How Green Was My Valley,1250000,0,0,-1250000,10,0,1941,-100.0
5155,56,2015-01-13,Da Sweet Blood of Jesus,1250000,0,0,-1250000,1,0,2015,-100.0
5156,57,2004-10-29,Saw,1200000,55968727,103880027,102680027,10,47911300,2004,8556.668916666666
5157,58,1989-08-04,"Sex, Lies, and Videotape",1200000,24741667,36741667,35541667,8,12000000,1989,2961.8055833333333
5158,59,2002-02-15,Super Troopers,1200000,18492362,23046142,21846142,2,4553780,2002,1820.5118333333335
5159,60,2002-02-22,Monsoon Wedding,1200000,13876974,27025600,25825600,2,13148626,2002,2152.1333333333337
5160,61,2000-11-10,You Can Count on Me,1200000,9180275,10827356,9627356,11,1647081,2000,802.2796666666667
5161,62,1951-07-03,Strangers on a Train,1200000,7000000,7000000,5800000,7,0,1951,483.3333333333333
5162,63,1955-10-03,The Trouble with Harry,1200000,7000000,7000000,5800000,10,0,1955,483.3333333333333
5163,64,1967-12-29,"Il buono, il brutto, il cattivo",1200000,6100000,6100000,4900000,12,0,1967,408.3333333333333
5164,65,1951-09-18,The Day the Earth Stood Still,1200000,3700000,3700000,2500000,9,0,1951,208.33333333333334
5165,66,2013-04-19,Home Run,1200000,2859955,2859955,1659955,4,0,2013,138.32958333333335
5166,67,1992-10-23,Reservoir Dogs,1200000,2832029,2832029,1632029,10,0,1992,136.00241666666665
5167,68,2000-07-07,But I'm a Cheerleader,1200000,2205627,2509344,1309344,7,303717,2000,109.11200000000001
5168,69,1956-12-23,The Wrong Man,1200000,2000000,2000000,800000,12,0,1956,66.66666666666666
5169,70,1975-09-26,The Rocky Horror Picture Show,1200000,1414845,1615976,415976,9,201131,1975,34.66466666666667
5170,71,1976-01-01,The Blue Bird,1200000,887000,887000,-313000,1,0,1976,-26.083333333333332
5171,72,2012-04-13,Blue Like Jazz,1200000,595018,595018,-604982,4,0,2012,-50.415166666666664
5172,73,2015-08-28,Que Horas Ela Volta?,1200000,376976,3249041,2049041,8,2872065,2015,170.75341666666665
5173,74,1982-11-19,Q,1200000,255000,255000,-945000,11,0,1982,-78.75
5174,75,2003-03-21,Down & Out with the Dolls,1200000,58936,58936,-1141064,3,0,2003,-95.08866666666667
5175,76,2012-06-01,"Pink Ribbons, Inc.",1200000,26608,26608,-1173392,6,0,2012,-97.78266666666666
5176,77,2018-02-06,Blood Feast,1200000,8708,8708,-1191292,2,0,2018,-99.27433333333333
5177,78,2011-02-11,Certifiably Jonathan,1200000,7826,7826,-1192174,2,0,2011,-99.34783333333334
5178,79,2015-09-18,La navaja de Don Juan,1200000,4254,4254,-1195746,9,0,2015,-99.6455
5179,80,2008-12-31,Extreme Movie,1200000,0,81338,-1118662,12,81338,2008,-93.22183333333334
5180,81,1936-10-20,The Charge of the Light Brigade,1200000,0,0,-1200000,10,0,1936,-100.0
5181,82,2004-06-18,Grand Theft Parsons,1200000,0,0,-1200000,6,0,2004,-100.0
5182,83,2012-08-28,Below Zero,1200000,0,0,-1200000,8,0,2012,-100.0
5183,84,2012-09-07,Crowsnest,1200000,0,0,-1200000,9,0,2012,-100.0
5184,85,2012-09-14,Airborne,1200000,0,0,-1200000,9,0,2012,-100.0
5185,86,2014-09-09,Cotton Comes to Harlem,1200000,0,0,-1200000,9,0,2014,-100.0
5186,87,2015-02-03,Bleeding Hearts,1200000,0,0,-1200000,2,0,2015,-100.0
5187,88,2013-12-31,The Wicked Within,1200000,0,0,-1200000,12,0,2013,-100.0
5188,89,2017-12-31,The Islands,1200000,0,0,-1200000,12,0,2017,-100.0
5189,90,2014-03-21,Godâs Not Dead,1150000,60755732,63777092,62627092,3,3021360,2014,5445.834086956522
5190,91,2005-10-07,Waiting...,1125000,16124543,18673274,17548274,10,2548731,2005,1559.8465777777778
5191,92,2006-05-12,Dead Man's Shoes,1125000,6408,414736,-710264,5,408328,2006,-63.13457777777778
5192,93,1980-02-01,The Fog,1100000,21445318,21445820,20345820,2,502,1980,1849.6200000000001
5193,94,2005-12-25,Wolf Creek,1100000,16186348,29005064,27905064,12,12818716,2005,2536.824
5194,95,2005-02-11,Ong-Bak,1100000,4563167,24062965,22962965,2,19499798,2005,2087.5422727272726
5195,96,2012-03-23,Serbuan maut,1100000,4105123,9297407,8197407,3,5192284,2012,745.2188181818182
5196,97,1986-09-26,Down by Law,1100000,1436000,1436000,336000,9,0,1986,30.545454545454547
5197,98,1987-09-04,The Offspring,1100000,1355728,1355728,255728,9,0,1987,23.247999999999998
5198,99,2002-02-22,Sex with Strangers,1100000,247740,247740,-852260,2,0,2002,-77.47818181818181
5199,100,2012-05-18,Beyond the Black Rainbow,1100000,56491,56491,-1043509,5,0,2012,-94.86445454545455
5200,1,2003-05-14,Dracula: Pages from a Virgin's Diary,1100000,39659,81371,-1018629,5,41712,2003,-92.60263636363636
5201,2,2014-11-21,The Sleepwalker,1100000,2636,2636,-1097364,11,0,2014,-99.76036363636364
5202,3,2017-03-07,Departure,1100000,0,27561,-1072439,3,27561,2017,-97.49445454545454
5203,4,2009-04-07,Faith Like Potatoes,1100000,0,0,-1100000,4,0,2009,-100.0
5204,5,2010-03-23,Lake Mungo,1100000,0,0,-1100000,3,0,2010,-100.0
5205,6,2015-04-07,Silent Running,1100000,0,0,-1100000,4,0,2015,-100.0
5206,7,2010-12-31,The Dead Undead,1100000,0,0,-1100000,12,0,2010,-100.0
5207,8,2013-12-31,The Vatican Exorcisms,1100000,0,0,-1100000,12,0,2013,-100.0
5208,9,2009-12-11,Rocket Singh: Salesman of the Year,1070000,164649,5348767,4278767,12,5184118,2009,399.8847663551402
5209,10,1943-01-23,Casablanca,1039000,10462500,10496855,9457855,1,34355,1943,910.2844080846968
5210,11,1976-11-21,Rocky,1000000,117235147,225000000,224000000,11,107764853,1976,22400.0
5211,12,2012-01-06,The Devil Inside,1000000,53262945,101759490,100759490,1,48496545,2012,10075.949
5212,13,1963-10-07,Tom Jones,1000000,37600000,37600000,36600000,10,0,1963,3660.0
5213,14,2015-04-17,Unfriended,1000000,32789645,64364198,63364198,4,31574553,2015,6336.419800000001
5214,15,1976-02-08,Taxi Driver,1000000,28262574,28316211,27316211,2,53637,1976,2731.6211
5215,16,2006-05-24,An Inconvenient Truth,1000000,24146161,53365925,52365925,5,29219764,2006,5236.5925
5216,17,2013-08-23,You're Next,1000000,18494006,26887177,25887177,8,8393171,2013,2588.7177
5217,18,2012-05-25,Chernobyl Diaries,1000000,18119640,42411721,41411721,5,24292081,2012,4141.1721
5218,19,1981-04-10,The Howling,1000000,17985000,17985000,16985000,4,0,1981,1698.5
5219,20,1963-05-08,Dr. No,1000000,16067035,59567035,58567035,5,43500000,1963,5856.7035
5220,21,1987-09-18,Hellraiser,1000000,14564000,14575148,13575148,9,11148,1987,1357.5148000000002
5221,22,2016-03-11,"Hello, My Name is Doris",1000000,14444999,14662703,13662703,3,217704,2016,1366.2703000000001
5222,23,2005-09-16,Cry Wolf,1000000,10047674,15943081,14943081,9,5895407,2005,1494.3081
5223,24,2000-08-18,Godzilla 2000,1000000,10037390,10037390,9037390,8,0,2000,903.739
5224,25,2010-12-29,Blue Valentine,1000000,9737892,16566240,15566240,12,6828348,2010,1556.624
5225,26,2006-01-20,Transamerica,1000000,9015303,16553163,15553163,1,7537860,2006,1555.3163
5226,27,1970-01-01,Beyond the Valley of the Dolls,1000000,9000000,9000000,8000000,1,0,1970,800.0
5227,28,1956-11-15,Love Me Tender,1000000,9000000,9000000,8000000,11,0,1956,800.0
5228,29,2018-07-20,Unfriended: Dark Web,1000000,8866745,16434588,15434588,7,7567843,2018,1543.4587999999999
5229,30,1949-12-14,Sands of Iwo Jima,1000000,7800000,7800000,6800000,12,0,1949,680.0
5230,31,2015-09-25,The Green Inferno,1000000,7192291,12931420,11931420,9,5739129,2015,1193.1419999999998
5231,32,2017-02-03,I Am Not Your Negro,1000000,7123919,9617402,8617402,2,2493483,2017,861.7402000000001
5232,33,2012-10-19,The Sessions,1000000,6002451,11495204,10495204,10,5492753,2012,1049.5203999999999
5233,34,2008-04-04,Shine a Light,1000000,5505267,16173879,15173879,4,10668612,2008,1517.3879
5234,35,2012-03-23,October Baby,1000000,5355847,5391992,4391992,3,36145,2012,439.1992
5235,36,2014-09-12,The Skeleton Twins,1000000,5284309,5797192,4797192,9,512883,2014,479.7192
5236,37,2013-06-14,20 Feet From Stardom,1000000,4946250,5892466,4892466,6,946216,2013,489.2466
5237,38,2009-06-12,"Food, Inc.",1000000,4417674,4731944,3731944,6,314270,2009,373.1944
5238,39,2017-07-28,An Inconvenient Sequel,1000000,3496795,5839322,4839322,7,2342527,2017,483.9322
5239,40,1998-08-21,Next Stop Wonderland,1000000,3395581,3465703,2465703,8,70122,1998,246.5703
5240,41,2014-06-06,Obvious Child,1000000,3122616,3324070,2324070,6,201454,2014,232.40699999999998
5241,42,2011-10-21,Martha Marcy May Marlene,1000000,2981038,5438911,4438911,10,2457873,2011,443.8911
5242,43,2005-08-03,Junebug,1000000,2678010,3553253,2553253,8,875243,2005,255.32530000000003
5243,44,2008-08-01,Frozen River,1000000,2511476,6030129,5030129,8,3518653,2008,503.01289999999995
5244,45,2001-11-21,Sidewalks of New York,1000000,2402459,3575308,2575308,11,1172849,2001,257.5308
5245,46,1998-04-24,Two Girls and a Guy,1000000,2057193,2315026,1315026,4,257833,1998,131.5026
5246,47,2000-09-29,The Broken Hearts Club: A Romantic Comedy,1000000,1744858,2022442,1022442,9,277584,2000,102.2442
5247,48,2006-06-28,Who Killed the Electric Car?,1000000,1678874,1849392,849392,6,170518,2006,84.9392
5248,49,2009-09-18,The Secrets of Jonathan Sperry,1000000,1355079,1355079,355079,9,0,2009,35.5079
5249,50,1996-07-17,Walking and Talking,1000000,1287480,1615787,615787,7,328307,1996,61.5787
5250,51,2003-09-19,Bubba Ho-Tep,1000000,1239183,1492895,492895,9,253712,2003,49.289500000000004
5251,52,2001-12-07,No Man's Land,1000000,1067481,2684207,1684207,12,1616726,2001,168.4207
5252,53,1998-10-09,Slam,1000000,1009819,1087521,87521,10,77702,1998,8.7521
5253,54,2017-10-06,Visages villages,1000000,952432,4015686,3015686,10,3063254,2017,301.5686
5254,55,2001-04-06,Brigham City,1000000,852206,852206,-147794,4,0,2001,-14.7794
5255,56,2017-08-18,Patti Cake$,1000000,800148,1471090,471090,8,670942,2017,47.109
5256,57,2000-12-01,Panic,1000000,779137,1425707,425707,12,646570,2000,42.5707
5257,58,2014-05-09,Palo Alto,1000000,767732,1156309,156309,5,388577,2014,15.6309
5258,59,2000-09-08,Fiza,1000000,623791,1179462,179462,9,555671,2000,17.9462
5259,60,2010-02-03,Ajami,1000000,621859,2721096,1721096,2,2099237,2010,172.1096
5260,61,1998-10-23,Orgazmo,1000000,582024,627287,-372713,10,45263,1998,-37.271300000000004
5261,62,2011-07-29,The Future,1000000,568662,1239174,239174,7,670512,2011,23.9174
5262,63,2003-02-14,All the Real Girls,1000000,549666,703020,-296980,2,153354,2003,-29.698
5263,64,2014-10-24,23 Blast,1000000,549185,549185,-450815,10,0,2014,-45.081500000000005
5264,65,1997-06-20,Dream With The Fishes,1000000,542909,542909,-457091,6,0,1997,-45.7091
5265,66,2013-07-19,The Act of Killing,1000000,486919,1227316,227316,7,740397,2013,22.7316
5266,67,2003-05-02,Blue Car,1000000,464126,475367,-524633,5,11241,2003,-52.463300000000004
5267,68,2007-10-19,Wristcutters: A Love Story,1000000,446165,473769,-526231,10,27604,2007,-52.6231
5268,69,2000-05-05,Luminarias,1000000,428535,428535,-571465,5,0,2000,-57.1465
5269,70,2014-07-18,I Origins,1000000,336472,852399,-147601,7,515927,2014,-14.760100000000001
5270,71,2014-11-28,Antarctica: A Year on Ice,1000000,288757,288757,-711243,11,0,2014,-71.12429999999999
5271,72,2003-08-22,The Battle of Shaker Heights,1000000,280351,839145,-160855,8,558794,2003,-16.0855
5272,73,2008-01-18,Taxi to the Dark Side,1000000,274661,304472,-695528,1,29811,2008,-69.5528
5273,74,2016-04-08,The Invitation,1000000,231738,354836,-645164,4,123098,2016,-64.51639999999999
5274,75,2004-09-24,Guiana 1838,1000000,227241,227241,-772759,9,0,2004,-77.2759
5275,76,2002-12-30,Love Liza,1000000,213137,213137,-786863,12,0,2002,-78.6863
5276,77,2006-07-07,Once in a Lifetime: the Extraordinary Story of the New York Cosmos,1000000,144601,215559,-784441,7,70958,2006,-78.4441
5277,78,2001-08-22,Lisa Picard is Famous,1000000,113433,113433,-886567,8,0,2001,-88.6567
5278,79,2015-07-31,Beyond the Brick: A LEGO Brickumentary,1000000,101531,101531,-898469,7,0,2015,-89.84689999999999
5279,80,2009-10-30,The House of the Devil,1000000,101215,102812,-897188,10,1597,2009,-89.7188
5280,81,2012-06-01,Hardflip,1000000,96734,96734,-903266,6,0,2012,-90.3266
5281,82,2016-03-11,Creative Control,1000000,63014,63014,-936986,3,0,2016,-93.6986
5282,83,2005-09-16,Chocolate: Deep Dark Secrets,1000000,49000,1549000,549000,9,1500000,2005,54.900000000000006
5283,84,2011-07-01,The Perfect Host,1000000,48764,51587,-948413,7,2823,2011,-94.84129999999999
5284,85,1998-09-25,The Last Big Thing,1000000,22434,22434,-977566,9,0,1998,-97.7566
5285,86,1998-08-07,Safe Men,1000000,21210,21210,-978790,8,0,1998,-97.879
5286,87,2001-08-31,Speedway Junky,1000000,17127,17127,-982873,8,0,2001,-98.2873
5287,88,2015-02-13,Hits,1000000,15156,15156,-984844,2,0,2015,-98.48440000000001
5288,89,2000-09-22,The Specials,1000000,12996,12996,-987004,9,0,2000,-98.7004
5289,90,2010-09-03,16 to Life,1000000,11574,11574,-988426,9,0,2010,-98.8426
5290,91,2007-01-17,Alone with Her,1000000,10787,844377,-155623,1,833590,2007,-15.5623
5291,92,2014-10-17,Camp X-Ray,1000000,9837,101053,-898947,10,91216,2014,-89.8947
5292,93,2008-11-21,Special,1000000,7202,26822,-973178,11,19620,2008,-97.3178
5293,94,2015-04-10,The Sisterhood of Night,1000000,6870,6870,-993130,4,0,2015,-99.313
5294,95,1999-03-19,Sparkler,1000000,5494,5494,-994506,3,0,1999,-99.4506
5295,96,2005-03-18,The Helixâ¦Loaded,1000000,3700,3700,-996300,3,0,2005,-99.63
5296,97,2015-05-15,Childless,1000000,1036,1036,-998964,5,0,2015,-99.8964
5297,98,2006-04-21,In Her Line of Fire,1000000,884,884,-999116,4,0,2006,-99.9116
5298,99,2002-12-13,The Jimmy Show,1000000,703,703,-999297,12,0,2002,-99.9297
5299,100,2013-12-31,Heli,1000000,0,552614,-447386,12,552614,2013,-44.7386
5300,1,2015-12-31,Karachi se Lahore,1000000,0,17721,-982279,12,17721,2015,-98.2279
5301,2,2006-12-31,Loving Annabelle,1000000,0,5382,-994618,12,5382,2006,-99.4618
5302,3,2015-12-11,American Hero,1000000,0,26,-999974,12,26,2015,-99.9974
5303,4,2009-12-01,Frat Party,1000000,0,0,-1000000,12,0,2009,-100.0
5304,5,2006-09-15,Jimmy and Judy,1000000,0,0,-1000000,9,0,2006,-100.0
5305,6,2003-10-24,The Party's Over,1000000,0,0,-1000000,10,0,2003,-100.0
5306,7,2009-07-17,The Poker House,1000000,0,0,-1000000,7,0,2009,-100.0
5307,8,2005-09-23,Proud,1000000,0,0,-1000000,9,0,2005,-100.0
5308,9,2008-12-31,Steppin: The Movie,1000000,0,0,-1000000,12,0,2008,-100.0
5309,10,2010-01-29,Zombies of Mass Destruction,1000000,0,0,-1000000,1,0,2010,-100.0
5310,11,2012-03-20,Snow White: A Deadly Summer,1000000,0,0,-1000000,3,0,2012,-100.0
5311,12,2012-10-09,Truth or Die,1000000,0,0,-1000000,10,0,2012,-100.0
5312,13,2013-05-14,Black Rock,1000000,0,0,-1000000,5,0,2013,-100.0
5313,14,2014-01-07,Hidden Away,1000000,0,0,-1000000,1,0,2014,-100.0
5314,15,2013-10-04,My Last Day Without You,1000000,0,0,-1000000,10,0,2013,-100.0
5315,16,2013-10-08,Zombie Hunter,1000000,0,0,-1000000,10,0,2013,-100.0
5316,17,2014-12-31,Doc Holliday's Revenge,1000000,0,0,-1000000,12,0,2014,-100.0
5317,18,2014-06-24,A Fine Step,1000000,0,0,-1000000,6,0,2014,-100.0
5318,19,2015-02-10,Fear Clinic,1000000,0,0,-1000000,2,0,2015,-100.0
5319,20,2015-03-10,The Pet,1000000,0,0,-1000000,3,0,2015,-100.0
5320,21,2014-12-31,Bang Bang Baby,1000000,0,0,-1000000,12,0,2014,-100.0
5321,22,2016-04-08,Hush,1000000,0,0,-1000000,4,0,2016,-100.0
5322,23,2016-03-01,1982,1000000,0,0,-1000000,3,0,2016,-100.0
5323,24,2015-10-27,The Horror Network,1000000,0,0,-1000000,10,0,2015,-100.0
5324,25,2016-12-31,Chemical Cut,1000000,0,0,-1000000,12,0,2016,-100.0
5325,26,2015-12-22,Por amor en el caserio,1000000,0,0,-1000000,12,0,2015,-100.0
5326,27,2007-06-01,And Then Came Love,989000,8158,8158,-980842,6,0,2007,-99.17512639029323
5327,28,2006-04-14,Hard Candy,950000,1024640,8267066,7317066,4,7242426,2006,770.2174736842105
5328,29,2002-09-27,Charly,950000,814666,814666,-135334,9,0,2002,-14.245684210526315
5329,30,2014-01-10,Banshee Chapter,950000,0,78122,-871878,1,78122,2014,-91.77663157894736
5330,31,2012-12-31,Trance,950000,0,0,-950000,12,0,2012,-100.0
5331,32,2014-08-12,Jesse,950000,0,0,-950000,8,0,2014,-100.0
5332,33,2015-03-03,Ask Me Anything,950000,0,0,-950000,3,0,2015,-100.0
5333,34,2012-04-13,L!fe Happens,930000,30905,30905,-899095,4,0,2012,-96.6768817204301
5334,35,2017-05-12,Lowriders,916000,6179955,6188421,5272421,5,8466,2017,575.5918122270742
5335,36,2014-11-21,Food Chains,913000,0,176,-912824,11,176,2014,-99.98072289156626
5336,37,1954-07-28,On the Waterfront,910000,9600000,9600000,8690000,7,0,1954,954.945054945055
5337,38,2013-07-12,Fruitvale Station,900000,16098998,17549645,16649645,7,1450647,2013,1849.9605555555554
5338,39,2016-04-01,Meet the Blacks,900000,9097072,9097072,8197072,4,0,2016,910.7857777777778
5339,40,2008-01-25,"4 luni, 3 saptamani si 2 zile",900000,1196321,11993156,11093156,1,10796835,2008,1232.5728888888889
5340,41,2011-08-26,Circumstance,900000,454121,958978,58978,8,504857,2011,6.553111111111111
5341,42,2006-08-25,The Quiet,900000,381420,381420,-518580,8,0,2006,-57.620000000000005
5342,43,2012-04-27,The Giant Mechanical Man,900000,7396,7396,-892604,4,0,2012,-99.17822222222222
5343,44,2013-04-05,The Brass Teapot,900000,6997,413733,-486267,4,406736,2013,-54.029666666666664
5344,45,2014-12-31,40 Weeks,900000,0,0,-900000,12,0,2014,-100.0
5345,46,2015-05-05,Le bonheur d'Elza,900000,0,0,-900000,5,0,2015,-100.0
5346,47,1942-08-13,Bambi,858000,102797000,268000000,267142000,8,165203000,1942,31135.431235431235
5347,48,2012-08-31,"For a Good Time, Call",850000,1251749,1386088,536088,8,134339,2012,63.06917647058824
5348,49,2004-01-30,Latter Days,850000,833118,865708,15708,1,32590,2004,1.848
5349,50,2008-03-21,The Hammer,850000,442638,442638,-407362,3,0,2008,-47.92494117647059
5350,51,2015-08-28,Windsor Drive,850000,3256,3256,-846744,8,0,2015,-99.61694117647059
5351,52,2012-12-31,Snitch,850000,0,0,-850000,12,0,2012,-100.0
5352,53,2008-12-31,Harrison Montgomery,850000,0,0,-850000,12,0,2008,-100.0
5353,54,2012-08-03,Celeste and Jesse Forever,840000,3103407,3787689,2947689,8,684282,2012,350.91535714285715
5354,55,2002-10-25,Time Changer,825000,1500711,1500711,675711,10,0,2002,81.90436363636364
5355,56,2009-08-11,London to Brighton,825000,0,610776,-214224,8,610776,2009,-25.966545454545454
5356,57,2009-12-31,Crying With Laughter,820000,0,16909,-803091,12,16909,2009,-97.93792682926829
5357,58,1971-01-01,Billy Jack,800000,98000000,98000000,97200000,1,0,1971,12150.0
5358,59,2011-12-30,Jodaeiye Nader az Simin,800000,7098492,24426169,23626169,12,17327677,2011,2953.2711249999998
5359,60,1996-05-10,Welcome to the Dollhouse,800000,4198137,5034794,4234794,5,836657,1996,529.34925
5360,61,2003-03-28,Raising Victor Vargas,800000,2073984,2900578,2100578,3,826594,2003,262.57225
5361,62,1993-10-01,Ruby in Paradise,800000,1001437,1001437,201437,10,0,1993,25.179625
5362,63,2002-08-09,Pandora's Box,800000,881950,881950,81950,8,0,2002,10.24375
5363,64,2007-07-18,Cama adentro,800000,200433,200433,-599567,7,0,2007,-74.945875
5364,65,2000-03-10,Deterrence,800000,144583,371647,-428353,3,227064,2000,-53.544125
5365,66,2004-05-07,The Mudge Boy,800000,62544,62544,-737456,5,0,2004,-92.182
5366,67,2003-04-11,The Young Unknowns,800000,58163,58163,-741837,4,0,2003,-92.729625
5367,68,2009-06-19,DÃ¸d snÃ¸,800000,46742,2194020,1394020,6,2147278,2009,174.2525
5368,69,2014-09-19,Not Cool,800000,35688,35688,-764312,9,0,2014,-95.539
5369,70,2012-02-03,Kill List,800000,29063,462206,-337794,2,433143,2012,-42.224250000000005
5370,71,2015-01-09,Vessel,800000,0,0,-800000,1,0,2015,-100.0
5371,72,2004-08-06,Saints and Soldiers,780000,1310470,1310470,530470,8,0,2004,68.00897435897436
5372,73,1973-08-11,American Graffiti,777000,115000000,140000000,139223000,8,25000000,1973,17918.018018018018
5373,74,2006-09-08,Iraq for Sale: The War Profiteers,775000,0,0,-775000,9,0,2006,-100.0
5374,75,2011-09-09,Kevin Hart: Laugh at My Pain,750000,7706436,7712436,6962436,9,6000,2011,928.3248000000001
5375,76,2007-04-13,Aqua Teen Hunger Force Colon Movie Film for Theaters,750000,5520368,5520368,4770368,4,0,2007,636.0490666666666
5376,77,2012-06-08,Safety Not Guaranteed,750000,4010957,4422318,3672318,6,411361,2012,489.64239999999995
5377,78,2012-02-03,The Innkeepers,750000,78396,1011535,261535,2,933139,2012,34.87133333333333
5378,79,2014-08-29,Il conformista,750000,59656,89609,-660391,8,29953,2014,-88.05213333333334
5379,80,2002-11-15,Interview with the Assassin,750000,47329,47329,-702671,11,0,2002,-93.68946666666666
5380,81,2005-07-01,Undead,750000,41196,229250,-520750,7,188054,2005,-69.43333333333334
5381,82,2009-01-23,Donkey Punch,750000,19367,814801,64801,1,795434,2009,8.640133333333333
5382,83,2013-10-11,All the Boys Love Mandy Lane,750000,0,1960521,1210521,10,1960521,2013,161.4028
5383,84,2014-12-31,Destiny,750000,0,450,-749550,12,450,2014,-99.94
5384,85,2009-04-07,Bled,750000,0,0,-750000,4,0,2009,-100.0
5385,86,2016-01-05,Adulterers,750000,0,0,-750000,1,0,2016,-100.0
5386,87,1968-06-25,La mariÃ©e Ã©tait en noir,747000,44566,44566,-702434,6,0,1968,-94.03400267737617
5387,88,1952-07-24,High Noon,730000,8000000,8000000,7270000,7,0,1952,995.890410958904
5388,89,1994-10-14,Hoop Dreams,700000,7768371,11768371,11068371,10,4000000,1994,1581.195857142857
5389,90,2005-06-24,Rize,700000,3278611,4857731,4157731,6,1579120,2005,593.9615714285713
5390,91,2006-08-11,Half Nelson,700000,2697938,4911725,4211725,8,2213787,2006,601.675
5391,92,2001-09-07,L.I.E.,700000,1140965,1140965,440965,9,0,2001,62.995000000000005
5392,93,2017-08-04,Columbus,700000,1017107,1110511,410511,8,93404,2017,58.64442857142858
5393,94,1999-10-08,Naturally Native,700000,10508,10508,-689492,10,0,1999,-98.49885714285715
5394,95,2010-01-26,B-Girl,700000,0,1160,-698840,1,1160,2010,-99.83428571428571
5395,96,2015-03-13,Walter,700000,0,0,-700000,3,0,2015,-100.0
5396,97,1933-04-07,King Kong,672000,10000000,10000650,9328650,4,650,1933,1388.1919642857144
5397,98,1953-04-10,House of Wax,658000,23800000,23800000,23142000,4,0,1953,3517.0212765957444
5398,99,1998-06-19,Hav Plenty,650000,2301777,2301777,1651777,6,0,1998,254.11953846153844
5399,100,2013-10-11,Escape from Tomorrow,650000,171962,171962,-478038,10,0,2013,-73.5443076923077
5400,1,2018-12-14,That Way Madness Lies,650000,1447,1447,-648553,12,0,2018,-99.77738461538462
5401,2,2012-12-31,After,650000,0,0,-650000,12,0,2012,-100.0
5402,3,2014-12-31,The Hadza: Last of the First,650000,0,0,-650000,12,0,2014,-100.0
5403,4,2009-12-31,Starsuckers,640000,0,14812,-625188,12,14812,2009,-97.685625
5404,5,2013-12-31,Treachery,625000,0,0,-625000,12,0,2013,-100.0
5405,6,1935-09-06,Top Hat,609000,1782000,3202000,2593000,9,1420000,1935,425.7799671592775
5406,7,1999-07-14,The Blair Witch Project,600000,140539099,248300000,247700000,7,107760901,1999,41283.33333333333
5407,8,1970-03-26,Woodstock,600000,34505110,34505110,33905110,3,0,1970,5650.8516666666665
5408,9,1977-08-10,The Kentucky Fried Movie,600000,15000000,20000000,19400000,8,5000000,1977,3233.3333333333335
5409,10,1967-05-10,Per qualche dollaro in piÃ¹,600000,4300000,4300000,3700000,5,0,1967,616.6666666666667
5410,11,2000-10-31,Mercy Streets,600000,173599,173599,-426401,10,0,2000,-71.06683333333334
5411,12,2014-05-02,Water & Power,600000,42557,42557,-557443,5,0,2014,-92.90716666666667
5412,13,2007-10-19,Arnolds Park,600000,23616,23616,-576384,10,0,2007,-96.06400000000001
5413,14,1999-07-02,Broken Vessels,600000,15030,85343,-514657,7,70313,1999,-85.77616666666667
5414,15,2015-05-22,Drunk Wedding,600000,3301,3301,-596699,5,0,2015,-99.44983333333333
5415,16,2016-03-04,They Will Have to Kill Us First,600000,0,7943,-592057,3,7943,2016,-98.67616666666666
5416,17,2002-08-23,Crop Circles: Quest for Truth,600000,0,0,-600000,8,0,2002,-100.0
5417,18,2014-08-08,The Maid's Room,600000,0,0,-600000,8,0,2014,-100.0
5418,19,2014-12-31,Light from the Darkroom,600000,0,0,-600000,12,0,2014,-100.0
5419,20,2015-02-24,Irreplaceable,600000,0,0,-600000,2,0,2015,-100.0
5420,21,1964-08-11,A Hard Day's Night,560000,1537860,1626784,1066784,8,88924,1964,190.49714285714285
5421,22,2011-07-29,The Harvest/La Cosecha,560000,3709,3709,-556291,7,0,2011,-99.33767857142857
5422,23,2015-12-31,Julija in alfa Romeo,560000,0,8462,-551538,12,8462,2015,-98.48892857142857
5423,24,1931-12-26,Mata Hari,558000,900000,900000,342000,12,0,1931,61.29032258064516
5424,25,1980-05-09,Friday the 13th,550000,39754601,59754601,59204601,5,20000000,1980,10764.47290909091
5425,26,1984-04-27,Love Letters,550000,5269990,5269990,4719990,4,0,1984,858.18
5426,27,2014-09-12,Faith Connections,550000,9111,9111,-540889,9,0,2014,-98.34345454545455
5427,28,2012-03-06,High Road,546173,0,0,-546173,3,0,2012,-100.0
5428,29,2008-09-26,Fireproof,500000,33456317,33473297,32973297,9,16980,2008,6594.6594000000005
5429,30,1974-11-15,Benji,500000,31559560,31559560,31059560,11,0,1974,6211.912
5430,31,2004-08-06,Open Water,500000,30500882,55518641,55018641,8,25017759,2004,11003.728200000001
5431,32,1977-01-01,Kingdom of the Spiders,500000,17000000,17000000,16500000,1,0,1977,3300.0
5432,33,2005-05-13,Mad Hot Ballroom,500000,8117961,9387581,8887581,5,1269620,2005,1777.5162000000003
5433,34,2003-10-03,The Station Agent,500000,5801558,9470209,8970209,10,3668651,2003,1794.0418000000002
5434,35,2010-01-22,To Save a Life,500000,3777210,3824868,3324868,1,47658,2010,664.9736
5435,36,2006-06-16,Wordplay,500000,3121270,3177636,2677636,6,56366,2006,535.5272
5436,37,1999-10-22,Beyond the Mat,500000,2047570,2047570,1547570,10,0,1999,309.51399999999995
5437,38,2002-02-01,The Singles Ward,500000,1250798,1250798,750798,2,0,2002,150.15959999999998
5438,39,2011-07-08,Sholem Aleichem: Laughing in the Darkness,500000,1131261,1131261,631261,7,0,2011,126.25219999999999
5439,40,2004-01-30,Osama,500000,1127331,1971479,1471479,1,844148,2004,294.2958
5440,41,2000-06-09,Groove,500000,1115313,1167524,667524,6,52211,2000,133.5048
5441,42,2003-01-31,The R.M.,500000,1111615,1111615,611615,1,0,2003,122.32300000000001
5442,43,1999-07-30,Twin Falls Idaho,500000,985341,1027228,527228,7,41887,1999,105.44560000000001
5443,44,2004-08-20,Mean Creek,500000,603951,1348750,848750,8,744799,2004,169.75
5444,45,2013-08-23,Drinking Buddies,500000,343706,407100,-92900,8,63394,2013,-18.58
5445,46,1998-02-13,Hurricane Streets,500000,334041,367582,-132418,2,33541,1998,-26.483600000000003
5446,47,2002-07-12,Never Again,500000,307631,308793,-191207,7,1162,2002,-38.2414
5447,48,1956-11-19,Shichinin no samurai,500000,271736,271736,-228264,11,0,1956,-45.6528
5448,49,2003-08-29,Civil Brand,500000,254293,254293,-245707,8,0,2003,-49.141400000000004
5449,50,2010-10-29,Monsters,500000,237301,5639730,5139730,10,5402429,2010,1027.946
5450,51,2006-03-24,Lonesome Jim,500000,154187,602789,102789,3,448602,2006,20.5578
5451,52,2013-04-17,Deceptive Practice: The Mysteries and Mentors of Ricky Jay,500000,152449,152449,-347551,4,0,2013,-69.5102
5452,53,2012-09-28,The Other Dream Team,500000,134109,314444,-185556,9,180335,2012,-37.1112
5453,54,2015-12-11,O Menino e o Mundo,500000,129479,280967,-219033,12,151488,2015,-43.8066
5454,55,2011-04-01,Rubber,500000,100370,680914,180914,4,580544,2011,36.1828
5455,56,1991-01-01,Johnny Suede,500000,55000,55000,-445000,1,0,1991,-89.0
5456,57,2007-10-05,Finishing the Game,500000,52850,53201,-446799,10,351,2007,-89.3598
5457,58,2008-04-18,Kiss the Bride,500000,32033,32033,-467967,4,0,2008,-93.5934
5458,59,2003-07-11,The Journey,500000,19800,19800,-480200,7,0,2003,-96.04
5459,60,2009-04-23,Home,500000,15433,44793168,44293168,4,44777735,2009,8858.633600000001
5460,61,2003-01-10,The Slaughter Rule,500000,13134,13134,-486866,1,0,2003,-97.3732
5461,62,2010-05-14,The Living Wake,500000,12232,12232,-487768,5,0,2010,-97.55359999999999
5462,63,2009-02-27,Scott Walker: 30 Century Man,500000,6840,77121,-422879,2,70281,2009,-84.5758
5463,64,2005-10-21,The Californians,500000,4134,4134,-495866,10,0,2005,-99.1732
5464,65,2014-09-10,Born to Fly: Elizabeth Streb vs. Gravity,500000,1822,1822,-498178,9,0,2014,-99.6356
5465,66,2013-06-28,Detention of the Dead,500000,1778,1778,-498222,6,0,2013,-99.6444
5466,67,2018-05-11,Higher Power,500000,528,528,-499472,5,0,2018,-99.8944
5467,68,2006-12-31,Feng kuang de shi tou,500000,0,3000000,2500000,12,3000000,2006,500.0
5468,69,2013-01-08,Now is Good,500000,0,2141436,1641436,1,2141436,2013,328.2872
5469,70,2006-12-31,Griffin & Phoenix,500000,0,1355967,855967,12,1355967,2006,171.1934
5470,71,2001-11-02,Everything Put Together,500000,0,7890,-492110,11,7890,2001,-98.422
5471,72,2010-12-31,Drones,500000,0,0,-500000,12,0,2010,-100.0
5472,73,2012-04-03,Enter Nowhere,500000,0,0,-500000,4,0,2012,-100.0
5473,74,2012-07-17,Girls Gone Dead,500000,0,0,-500000,7,0,2012,-100.0
5474,75,2005-12-31,Insomnia Manica,500000,0,0,-500000,12,0,2005,-100.0
5475,76,2014-12-31,America Is Still The Place,500000,0,0,-500000,12,0,2014,-100.0
5476,77,2015-07-24,The Outrageous Sophie Tucker,500000,0,0,-500000,7,0,2015,-100.0
5477,78,2015-03-10,Subconscious,500000,0,0,-500000,3,0,2015,-100.0
5478,79,2015-04-14,Roadside,500000,0,0,-500000,4,0,2015,-100.0
5479,80,2014-12-31,Diamond Ruff,500000,0,0,-500000,12,0,2014,-100.0
5480,81,2015-02-10,Love in the Time of Monsters,500000,0,0,-500000,2,0,2015,-100.0
5481,82,2012-12-31,El rey de Najayo,500000,0,0,-500000,12,0,2012,-100.0
5482,83,2015-12-31,Fight to the Finish,500000,0,0,-500000,12,0,2015,-100.0
5483,84,2013-12-31,Bucky and the Squirrels,500000,0,0,-500000,12,0,2013,-100.0
5484,85,1990-12-31,Going Under,500000,0,0,-500000,12,0,1990,-100.0
5485,86,2015-06-23,Crossroads,500000,0,0,-500000,6,0,2015,-100.0
5486,87,2015-08-11,Alleluia! The Devil's Carnival,500000,0,0,-500000,8,0,2015,-100.0
5487,88,2015-12-01,Brooklyn Bizarre,500000,0,0,-500000,12,0,2015,-100.0
5488,89,2014-12-31,The Sound and the Shadow,500000,0,0,-500000,12,0,2014,-100.0
5489,90,2015-12-31,Rodeo Girl,500000,0,0,-500000,12,0,2015,-100.0
5490,91,2015-11-10,The Little Ponderosa Zoo,500000,0,0,-500000,11,0,2015,-100.0
5491,92,1984-12-31,The Toxic Avenger,475000,0,0,-475000,12,0,1984,-100.0
5492,93,2009-09-25,Paranormal Activity,450000,107918810,194183034,193733034,9,86264224,2009,43051.78533333333
5493,94,1991-01-01,Straight out of Brooklyn,450000,2712293,2712293,2262293,1,0,1991,502.73177777777784
5494,95,2006-03-31,Brick,450000,2075743,4243996,3793996,3,2168253,2006,843.1102222222222
5495,96,1997-08-22,Sunday,450000,410919,450349,349,8,39430,1997,0.07755555555555556
5496,97,2006-08-11,Conversations with Other Women,450000,379418,1297745,847745,8,918327,2006,188.38777777777779
5497,98,2015-11-20,Siakh lokhamim: ha'slilim ha'gnouzim,450000,41260,42503,-407497,11,1243,2015,-90.55488888888888
5498,99,2008-05-09,Poultrygeist: Night of the Chicken Dead,450000,13804,22623,-427377,5,8819,2008,-94.97266666666667
5499,100,2014-07-11,As It Is in Heaven,450000,13486,13486,-436514,7,0,2014,-97.00311111111111
5500,1,2014-07-01,Mutual Friends,450000,0,0,-450000,7,0,2014,-100.0
5501,2,2014-12-31,Rise Of the Entrepreneur - The Search For A Better Way,450000,0,0,-450000,12,0,2014,-100.0
5502,3,1933-03-09,42nd Street,439000,1438000,2281000,1842000,3,843000,1933,419.5899772209567
5503,4,1990-08-03,Metropolitan,430000,2938000,2938000,2508000,8,0,1990,583.2558139534884
5504,5,2006-04-28,Moartea domnului Lazarescu,425000,80301,581304,156304,4,501003,2006,36.77741176470588
5505,6,2005-01-21,Gory Gory Hallelujah,425000,12604,12604,-412396,1,0,2005,-97.03435294117646
5506,7,2014-04-25,Blue Ruin,420000,258384,437002,17002,4,178618,2014,4.048095238095238
5507,8,2004-06-11,Napoleon Dynamite,400000,44540956,46122713,45722713,6,1581757,2004,11430.678249999999
5508,9,1975-05-10,Monty Python and the Holy Grail,400000,3427696,5028948,4628948,5,1601252,1975,1157.2369999999999
5509,10,2006-08-02,Quinceanera,400000,1692693,2797199,2397199,8,1104506,2006,599.29975
5510,11,2002-04-26,Dogtown and Z-Boys,400000,1293295,1600566,1200566,4,307271,2002,300.1415
5511,12,2008-10-24,Heroes,400000,655538,655538,255538,10,0,2008,63.8845
5512,13,2004-10-06,Tarnation,400000,592014,1162014,762014,10,570000,2004,190.5035
5513,14,2010-10-15,I Want Your Money,400000,433588,433588,33588,10,0,2010,8.397
5514,15,1983-01-01,E tu vivrai nel terrore - L'aldilÃ,400000,126387,126387,-273613,1,0,1983,-68.40325
5515,16,1980-05-16,Home Movies,400000,89134,89134,-310866,5,0,1980,-77.7165
5516,17,2001-07-27,Jackpot,400000,44452,44452,-355548,7,0,2001,-88.887
5517,18,2004-12-10,Fabled,400000,31425,31425,-368575,12,0,2004,-92.14375
5518,19,2005-10-13,The Dark Hours,400000,423,423,-399577,10,0,2005,-99.89425
5519,20,2015-03-31,Viskningar och rop,400000,0,9071,-390929,3,9071,2015,-97.73225
5520,21,1986-04-01,My Beautiful Laundrette,400000,0,0,-400000,4,0,1986,-100.0
5521,22,2005-11-04,Show Me,400000,0,0,-400000,11,0,2005,-100.0
5522,23,2014-12-31,Pancakes,400000,0,0,-400000,12,0,2014,-100.0
5523,24,1916-09-05,Intolerance,385907,0,0,-385907,9,0,1916,-100.0
5524,25,1929-02-01,The Broadway Melody,379000,2800000,4358000,3979000,2,1558000,1929,1049.8680738786281
5525,26,1983-04-15,The Evil Dead,375000,2400000,29400000,29025000,4,27000000,1983,7740.000000000001
5526,27,1999-05-21,Trekkies,375000,617172,617172,242172,5,0,1999,64.5792
5527,28,1980-01-01,Maniac,350000,10000000,10000000,9650000,1,0,1980,2757.1428571428573
5528,29,1987-01-01,American Ninja 2: The Confrontation,350000,4000000,4000000,3650000,1,0,1987,1042.857142857143
5529,30,2005-07-08,Murderball,350000,1531154,1772979,1422979,7,241825,2005,406.5654285714285
5530,31,2010-09-01,My Dog Tulip,350000,246574,310891,-39109,9,64317,2010,-11.174000000000001
5531,32,2006-10-18,51 Birch Street,350000,84689,84689,-265311,10,0,2006,-75.80314285714286
5532,33,2002-11-15,Revolution#9,350000,9118,9118,-340882,11,0,2002,-97.39485714285713
5533,34,2009-04-10,Royal Kill,350000,0,0,-350000,4,0,2009,-100.0
5534,35,2015-10-20,Rotor DR1,350000,0,0,-350000,10,0,2015,-100.0
5535,36,1957-04-13,12 Angry Men,340000,0,0,-340000,4,0,1957,-100.0
5536,37,1978-10-17,Halloween,325000,47000000,70000000,69675000,10,23000000,1978,21438.46153846154
5537,38,1934-02-22,It Happened One Night,325000,2500000,2500000,2175000,2,0,1934,669.2307692307693
5538,39,2010-06-25,Kynodontas,323000,110248,1373407,1050407,6,1263159,2010,325.2034055727554
5539,40,1999-11-24,Tumbleweeds,312000,1350248,1788168,1476168,11,437920,1999,473.1307692307692
5540,41,2003-11-14,Tupac Resurrection,300000,7718961,7808524,7508524,11,89563,2003,2502.8413333333333
5541,42,2000-03-10,God's Army,300000,2637726,2652515,2352515,3,14789,2000,784.1716666666666
5542,43,2003-10-17,Pieces of April,300000,2528664,3571253,3271253,10,1042589,2003,1090.4176666666667
5543,44,1996-09-20,When The Cat's Away,300000,1652472,2525984,2225984,9,873512,1996,741.9946666666666
5544,45,2008-12-10,Wendy and Lucy,300000,865695,1416046,1116046,12,550351,2008,372.01533333333333
5545,46,1998-09-11,Let's Talk About Sex,300000,373615,373615,73615,9,0,1998,24.538333333333334
5546,47,2006-08-25,Old Joy,300000,255923,399908,99908,8,143985,2006,33.30266666666667
5547,48,2005-07-15,First Morning,300000,87264,87264,-212736,7,0,2005,-70.91199999999999
5548,49,2007-06-15,Pierrot le fou,300000,70807,71380,-228620,6,573,2007,-76.20666666666666
5549,50,1997-03-05,The Watermelon Woman,300000,42735,42735,-257265,3,0,1997,-85.75500000000001
5550,51,2011-03-11,3 Backyards,300000,39475,39475,-260525,3,0,2011,-86.84166666666667
5551,52,2006-04-12,Sisters in Law,300000,33312,33312,-266688,4,0,2006,-88.896
5552,53,2012-11-09,Nothing But a Man,300000,17241,17241,-282759,11,0,2012,-94.253
5553,54,2002-07-19,Ayurveda: Art of Being,300000,16892,2066892,1766892,7,2050000,2002,588.9639999999999
5554,55,1998-08-07,"First Love, Last Rites",300000,10876,10876,-289124,8,0,1998,-96.37466666666667
5555,56,2005-05-06,Fighting Tommy Riley,300000,10514,10514,-289486,5,0,2005,-96.49533333333333
5556,57,2014-03-28,Locker 13,300000,3496,3496,-296504,3,0,2014,-98.83466666666666
5557,58,2015-10-23,The Looking Glass,300000,1711,1711,-298289,10,0,2015,-99.42966666666668
5558,59,2014-10-31,All You Need Is Love,300000,0,3565259,3265259,10,3565259,2014,1088.4196666666667
5559,60,1975-04-01,Death Race 2000,300000,0,0,-300000,4,0,1975,-100.0
5560,61,2012-07-03,Some Guy Who Kills People,300000,0,0,-300000,7,0,2012,-100.0
5561,62,2013-08-07,Midnight Cabaret,300000,0,0,-300000,8,0,2013,-100.0
5562,63,2015-03-10,Teeth and Blood,300000,0,0,-300000,3,0,2015,-100.0
5563,64,2015-12-31,Walking to Paris,300000,0,0,-300000,12,0,2015,-100.0
5564,65,2010-12-31,Anderson's Cross,300000,0,0,-300000,12,0,2010,-100.0
5565,66,2015-12-08,Amidst the Devil's Wings,300000,0,0,-300000,12,0,2015,-100.0
5566,67,2010-12-31,Death Calls,290000,0,0,-290000,12,0,2010,-100.0
5567,68,2012-08-17,Compliance,270000,319285,830700,560700,8,511415,2012,207.66666666666666
5568,69,1981-05-01,Graduation Day,250000,23894000,23894000,23644000,5,0,1981,9457.599999999999
5569,70,1997-04-04,Chasing Amy,250000,12006514,15155095,14905095,4,3148581,1997,5962.038
5570,71,2002-06-28,Lovely and Amazing,250000,4210379,4613482,4363482,6,403103,2002,1745.3928
5571,72,2017-04-28,Sleight,250000,3930990,3934450,3684450,4,3460,2017,1473.78
5572,73,2003-04-11,Better Luck Tomorrow,250000,3802390,3809226,3559226,4,6836,2003,1423.6904
5573,74,2011-10-28,Like Crazy,250000,3395391,3728400,3478400,10,333009,2011,1391.3600000000001
5574,75,1995-06-16,The Incredibly True Adventure of Two Girls in Love,250000,2210408,2477155,2227155,6,266747,1995,890.8620000000001
5575,76,2000-07-14,Chuck&Buck,250000,1055671,1157672,907672,7,102001,2000,363.0688
5576,77,2001-03-16,American Desi,250000,902835,1366235,1116235,3,463400,2001,446.494
5577,78,1998-09-11,Cube,250000,489220,8969065,8719065,9,8479845,1998,3487.626
5578,79,1997-03-28,Love and Other Catastrophes,250000,212285,743216,493216,3,530931,1997,197.2864
5579,80,1998-08-28,I Married a Strange Person,250000,203134,203134,-46866,8,0,1998,-18.746399999999998
5580,81,2005-07-22,November,250000,191862,191862,-58138,7,0,2005,-23.255200000000002
5581,82,1999-09-17,Sugar Town,250000,178095,178095,-71905,9,0,1999,-28.762
5582,83,2008-03-28,Happy Valley,250000,67665,67665,-182335,3,0,2008,-72.934
5583,84,2013-08-02,The Canyons,250000,59671,62375,-187625,8,2704,2013,-75.05
5584,85,2006-06-28,The Motel,250000,51540,51540,-198460,6,0,2006,-79.384
5585,86,2005-07-15,On the Outs,250000,49772,237816,-12184,7,188044,2005,-4.8736
5586,87,2007-12-14,Shotgun Stories,250000,46026,284174,34174,12,238148,2007,13.6696
5587,88,2014-08-15,Nightlights,250000,21147,21147,-228853,8,0,2014,-91.5412
5588,89,2014-06-06,Test,250000,18823,18823,-231177,6,0,2014,-92.4708
5589,90,1999-01-08,The Sticky Fingers of Time,250000,18195,20628,-229372,1,2433,1999,-91.7488
5590,91,2015-03-24,Along the Roadside,250000,0,3234,-246766,3,3234,2015,-98.7064
5591,92,2008-10-21,Sunday School Musical,250000,0,0,-250000,10,0,2008,-100.0
5592,93,2010-10-05,Rust,250000,0,0,-250000,10,0,2010,-100.0
5593,94,2010-12-31,The Christmas Bunny,250000,0,0,-250000,12,0,2010,-100.0
5594,95,2009-11-10,Ink,250000,0,0,-250000,11,0,2009,-100.0
5595,96,2012-12-18,The Frozen,250000,0,0,-250000,12,0,2012,-100.0
5596,97,2014-04-11,Jesus People,250000,0,0,-250000,4,0,2014,-100.0
5597,98,2010-12-31,Butterfly,250000,0,0,-250000,12,0,2010,-100.0
5598,99,2015-02-03,UnDivided,250000,0,0,-250000,2,0,2015,-100.0
5599,100,2014-12-31,Horse Camp,250000,0,0,-250000,12,0,2014,-100.0
5600,1,2015-02-24,Give Me Shelter,250000,0,0,-250000,2,0,2015,-100.0
5601,2,2011-12-31,Rock the House,250000,0,0,-250000,12,0,2011,-100.0
5602,3,2015-12-31,Shooting the Warwicks,250000,0,0,-250000,12,0,2015,-100.0
5603,4,2015-08-18,The Love Letter,250000,0,0,-250000,8,0,2015,-100.0
5604,5,2015-10-09,Western Religion,250000,0,0,-250000,10,0,2015,-100.0
5605,6,2015-01-01,4/11,250000,0,0,-250000,1,0,2015,-100.0
5606,7,1925-11-19,The Big Parade,245000,11000000,22000000,21755000,11,11000000,1925,8879.591836734695
5607,8,2008-10-31,Little Big Top,240000,7484,7484,-232516,10,0,2008,-96.88166666666666
5608,9,2009-10-09,Bronson,230000,104979,2703762,2473762,10,2598783,2009,1075.548695652174
5609,10,2012-07-20,Burn,225000,1109276,1109276,884276,7,0,2012,393.01155555555556
5610,11,2000-09-15,Urbania,225000,1032075,1032075,807075,9,0,2000,358.70000000000005
5611,12,1953-06-13,"The Beast from 20,000 Fathoms",210000,5000000,5000000,4790000,6,0,1953,2280.952380952381
5612,13,1969-07-25,The Stewardesses,200000,13500000,25000000,24800000,7,11500000,1969,12400.0
5613,14,1980-03-21,Mad Max,200000,8750000,99750000,99550000,3,91000000,1980,49775.0
5614,15,1916-12-24,"20,000 Leagues Under the Sea",200000,8000000,8000000,7800000,12,0,1916,3900.0
5615,16,1996-10-18,Swingers,200000,4505922,6618578,6418578,10,2112656,1996,3209.2889999999998
5616,17,1967-01-18,Per un pugno di dollari,200000,3500000,3516248,3316248,1,16248,1967,1658.124
5617,18,2011-02-25,The Grace Card,200000,2430735,2430735,2230735,2,0,2011,1115.3675
5618,19,1933-02-09,She Done Him Wrong,200000,2000000,2000000,1800000,2,0,1933,900.0
5619,20,2000-02-11,Trois,200000,1161843,1161843,961843,2,0,2000,480.9215
5620,21,2015-06-19,The Overnight,200000,1109808,1165996,965996,6,56188,2015,482.998
5621,22,2004-10-22,Short Cut to Nirvana: Kumbh Mela,200000,381225,439651,239651,10,58426,2004,119.8255
5622,23,2012-10-12,Middle of Nowhere,200000,236806,236806,36806,10,0,2012,18.403
5623,24,2008-10-10,Call+Response,200000,212989,212989,12989,10,0,2008,6.4945
5624,25,2002-05-10,The Business of Fancy Dancing,200000,174682,174682,-25318,5,0,2002,-12.659
5625,26,2002-05-10,Hybrid,200000,162605,162605,-37395,5,0,2002,-18.6975
5626,27,2008-06-13,Baghead,200000,140016,140016,-59984,6,0,2008,-29.992
5627,28,2004-09-10,Malevolence,200000,126021,346106,146106,9,220085,2004,73.053
5628,29,2005-09-09,Side Effects,200000,44701,44701,-155299,9,0,2005,-77.6495
5629,30,2008-10-10,Good Dick,200000,28835,52443,-147557,10,23608,2008,-73.77850000000001
5630,31,2006-07-21,The Case of the Grinning Cat,200000,7033,7033,-192967,7,0,2006,-96.4835
5631,32,2005-01-07,Solitude,200000,6260,6260,-193740,1,0,2005,-96.87
5632,33,2014-03-14,The Word,200000,3648,3648,-196352,3,0,2014,-98.176
5633,34,2007-06-15,The Trials of Darryl Hunt,200000,1217,1217,-198783,6,0,2007,-99.3915
5634,35,2007-10-19,The Man From Earth,200000,0,0,-200000,10,0,2007,-100.0
5635,36,2004-12-31,Samantha: An American Girl Holiday,200000,0,0,-200000,12,0,2004,-100.0
5636,37,2008-01-17,Yesterday Was a Lie,200000,0,0,-200000,1,0,2008,-100.0
5637,38,2014-09-12,Archaeology of a Woman,200000,0,0,-200000,9,0,2014,-100.0
5638,39,2014-08-26,Sanctuary; Quite a Conundrum,200000,0,0,-200000,8,0,2014,-100.0
5639,40,2015-09-29,Theresa Is a Mother,200000,0,0,-200000,9,0,2015,-100.0
5640,41,2015-11-10,Perfect Cowboy,200000,0,0,-200000,11,0,2015,-100.0
5641,42,2014-12-31,H.,200000,0,0,-200000,12,0,2014,-100.0
5642,43,2011-09-23,Weekend,190000,484592,1577585,1387585,9,1092993,2011,730.3078947368422
5643,44,1999-01-22,Bacheha-Ye aseman,180000,933933,1628579,1448579,1,694646,1999,804.7661111111111
5644,45,2015-02-27,Butterfly Girl,180000,17503,17503,-162497,2,0,2015,-90.2761111111111
5645,46,2017-06-16,Arrowhead,180000,0,0,-180000,6,0,2017,-100.0
5646,47,1986-08-08,She's Gotta Have It,175000,7137502,7137502,6962502,8,0,1986,3978.572571428571
5647,48,2011-07-22,Another Earth,175000,1321194,2102779,1927779,7,781585,2011,1101.588
5648,49,2013-08-23,Sparrows Dance,175000,2602,2602,-172398,8,0,2013,-98.51314285714285
5649,50,2015-09-04,Heroes of Dirt,175000,0,0,-175000,9,0,2015,-100.0
5650,51,2016-06-03,The Fits,170000,166425,169242,-758,6,2817,2016,-0.4458823529411765
5651,52,1979-06-30,Dolphin,170000,14000,14000,-156000,6,0,1979,-91.76470588235294
5652,53,2015-12-31,Lumea e a mea,168000,0,29678,-138322,12,29678,2015,-82.3345238095238
5653,54,2009-09-11,The Horse Boy,160000,156612,156612,-3388,9,0,2009,-2.1174999999999997
5654,55,2002-03-01,The Calling,160000,32092,32092,-127908,3,0,2002,-79.94250000000001
5655,56,1971-01-01,Sweet Sweetback's Baad Asssss Song,150000,15200000,15200000,15050000,1,0,1971,10033.333333333332
5656,57,2007-05-16,Once,150000,9445857,23323631,23173631,5,13877774,2007,15449.087333333333
5657,58,2002-07-19,Tadpole,150000,2891288,3270128,3120128,7,378840,2002,2080.0853333333334
5658,59,2000-06-23,The Woman Chaser,150000,110719,110719,-39281,6,0,2000,-26.187333333333335
5659,60,2015-04-17,Antarctic Edge: 70Âº South,150000,7193,7193,-142807,4,0,2015,-95.20466666666667
5660,61,2015-08-21,Top Spin,150000,5858,5858,-144142,8,0,2015,-96.09466666666665
5661,62,2013-12-31,Speak No Evil,150000,0,32927,-117073,12,32927,2013,-78.04866666666666
5662,63,2009-10-06,A Charlie Brown Christmas,150000,0,0,-150000,10,0,2009,-100.0
5663,64,2013-05-03,Aroused,150000,0,0,-150000,5,0,2013,-100.0
5664,65,2015-12-31,Escaping the Holocost,150000,0,0,-150000,12,0,2015,-100.0
5665,66,1974-10-18,The Texas Chainsaw Massacre,140000,26572439,26572439,26432439,10,0,1974,18880.31357142857
5666,67,1989-12-20,Roger & Me,140000,6706368,6706368,6566368,12,0,1989,4690.262857142857
5667,68,2012-04-27,Sound of My Voice,135000,408015,429448,294448,4,21433,2012,218.1096296296296
5668,69,1942-11-16,Cat People,134000,4000000,8000000,7866000,11,4000000,1942,5870.149253731343
5669,70,2014-07-18,An American in Hollywood,125000,0,0,-125000,7,0,2014,-100.0
5670,71,2015-08-11,The Brain That Sings,125000,0,0,-125000,8,0,2015,-100.0
5671,72,2015-12-31,Romantic Schemer,125000,0,0,-125000,12,0,2015,-100.0
5672,73,2012-06-15,Your Sister's Sister,120000,1597486,3090593,2970593,6,1493107,2012,2475.494166666667
5673,74,2006-06-30,The Blood of My Brother: A Story of Death in Iraq,120000,0,0,-120000,6,0,2006,-100.0
5674,75,2007-12-31,A Dog's Breakfast,120000,0,0,-120000,12,0,2007,-100.0
5675,76,2016-05-24,Une Femme MariÃ©e,120000,0,0,-120000,5,0,2016,-100.0
5676,77,1968-10-01,Night of the Living Dead,114000,12087064,30087064,29973064,10,18000000,1968,26292.16140350877
5677,78,1915-02-08,The Birth of a Nation,110000,10000000,11000000,10890000,2,1000000,1915,9900.0
5678,79,2003-10-03,The Work and the Story,103000,16137,16137,-86863,10,0,2003,-84.33300970873786
5679,80,2015-07-10,The Gallows,100000,22764410,41656474,41556474,7,18892064,2015,41556.473999999995
5680,81,2006-09-29,Facing the Giants,100000,10178331,10243159,10143159,9,64828,2006,10143.159
5681,82,1977-01-01,Eraserhead,100000,7000000,7014590,6914590,1,14590,1977,6914.59
5682,83,1987-03-01,Hollywood Shuffle,100000,5228617,5228617,5128617,3,0,1987,5128.617
5683,84,1920-09-17,Over the Hill to the Poorhouse,100000,3000000,3000000,2900000,9,0,1920,2900.0
5684,85,1998-10-09,The Mighty,100000,2652246,6121582,6021582,10,3469336,1998,6021.582
5685,86,2017-07-07,A Ghost Story,100000,1594798,2769782,2669782,7,1174984,2017,2669.782
5686,87,1980-05-10,Penitentiary,100000,287000,287000,187000,5,0,1980,187.0
5687,88,2004-02-06,The Lost Skeleton of Cadavra,100000,110536,110536,10536,2,0,2004,10.536
5688,89,2014-03-21,Cheap Thrills,100000,59424,59424,-40576,3,0,2014,-40.576
5689,90,2014-06-19,The Past is a Grotesque Animal,100000,20056,20056,-79944,6,0,2014,-79.944
5690,91,2001-11-09,Keeping it Real: The Adventures of Greg Walloch,100000,1358,1358,-98642,11,0,2001,-98.642
5691,92,2012-05-18,Indie Game: The Movie,100000,0,0,-100000,5,0,2012,-100.0
5692,93,2014-12-31,"Dude, Where's My Dog",100000,0,0,-100000,12,0,2014,-100.0
5693,94,2014-06-10,Echo Dr.,100000,0,0,-100000,6,0,2014,-100.0
5694,95,2015-03-17,Closure,100000,0,0,-100000,3,0,2015,-100.0
5695,96,2015-12-31,Lunchtime Heroes,100000,0,0,-100000,12,0,2015,-100.0
5696,97,2015-03-25,Open Secret,100000,0,0,-100000,3,0,2015,-100.0
5697,98,2015-11-10,The Night Visitor,100000,0,0,-100000,11,0,2015,-100.0
5698,99,2015-07-07,Tiger Orange,100000,0,0,-100000,7,0,2015,-100.0
5699,100,1972-08-30,The Last House on the Left,87000,3100000,3100000,3013000,8,0,1972,3463.218390804597
5700,1,2008-05-30,The Foot Fist Way,79000,234286,234286,155286,5,0,2008,196.56455696202534
5701,2,2015-07-17,Dawn of the Crescent Moon,75000,8799,8799,-66201,7,0,2015,-88.268
5702,3,2015-09-29,Queen Crab,75000,0,0,-75000,9,0,2015,-100.0
5703,4,2014-07-25,Happy Christmas,70000,30312,30312,-39688,7,0,2014,-56.69714285714286
5704,5,2005-01-28,"Peace, Propaganda and the Promised Land",70000,4930,4930,-65070,1,0,2005,-92.95714285714286
5705,6,2011-12-31,Absentia,70000,0,8555,-61445,12,8555,2011,-87.77857142857142
5706,7,1998-07-10,Pi,68000,3221152,4678513,4610513,7,1457361,1998,6780.166176470589
5707,8,1998-02-20,I Love You â¦ Don't Touch Me!,68000,33598,33598,-34402,2,0,1998,-50.59117647058824
5708,9,1999-02-26,20 Dates,66000,541636,602920,536920,2,61284,1999,813.5151515151515
5709,10,2004-05-07,Super Size Me,65000,11529368,22233808,22168808,5,10704440,2004,34105.85846153846
5710,11,2013-01-25,Supporting Characters,60000,4917,4917,-55083,1,0,2013,-91.805
5711,12,2012-03-16,The FP,60000,0,0,-60000,3,0,2012,-100.0
5712,13,2012-12-31,Hayride,60000,0,0,-60000,12,0,2012,-100.0
5713,14,1962-08-10,The Brain That Wouldn't Die,60000,0,0,-60000,8,0,1962,-100.0
5714,15,2013-10-04,The Dirties,55000,0,0,-55000,10,0,2013,-100.0
5715,16,1995-08-09,The Brothers McMullen,50000,10426506,10426506,10376506,8,0,1995,20753.012000000002
5716,17,2001-03-16,Gabriela,50000,2335352,2335352,2285352,3,0,2001,4570.704
5717,18,2010-11-12,Tiny Furniture,50000,391674,424149,374149,11,32475,2010,748.298
5718,19,2008-02-22,The Signal,50000,251150,406299,356299,2,155149,2008,712.5980000000001
5719,20,2015-07-31,Counting,50000,8374,8374,-41626,7,0,2015,-83.25200000000001
5720,21,2009-12-31,Big Things,50000,0,0,-50000,12,0,2009,-100.0
5721,22,2014-02-14,Down and Dangerous,50000,0,0,-50000,2,0,2014,-100.0
5722,23,2005-12-31,The Call of Cthulhu,50000,0,0,-50000,12,0,2005,-100.0
5723,24,2015-08-04,Bending Steel,50000,0,0,-50000,8,0,2015,-100.0
5724,25,2015-09-01,"Run, Hide, Die",50000,0,0,-50000,9,0,2015,-100.0
5725,26,2014-12-31,The Image Revolution,50000,0,0,-50000,12,0,2014,-100.0
5726,27,2013-10-25,A True Story,45000,0,0,-45000,10,0,2013,-100.0
5727,28,2000-10-27,George Washington,42000,241816,342722,300722,10,100906,2000,716.004761904762
5728,29,2013-06-21,This Is Martin Bonner,42000,0,0,-42000,6,0,2013,-100.0
5729,30,2000-08-25,Smiling Fish and Goat on Fire,40000,277233,277233,237233,8,0,2000,593.0825
5730,31,2010-03-12,The Exploding Girl,40000,25572,25572,-14428,3,0,2010,-36.07
5731,32,2011-02-11,Raymond Did It,40000,3632,3632,-36368,2,0,2011,-90.92
5732,33,2012-03-31,Foreign Letters,40000,0,0,-40000,3,0,2012,-100.0
5733,34,1991-07-01,The Last Waltz,35000,321952,322563,287563,7,611,1991,821.6085714285715
5734,35,2013-10-25,Her Cry: La Llorona Investigation,35000,0,0,-35000,10,0,2013,-100.0
5735,36,2014-12-31,Happy 40th,35000,0,0,-35000,12,0,2014,-100.0
5736,37,2008-07-18,The Legend of God's Gun,30000,243768,243768,213768,7,0,2008,712.5600000000001
5737,38,2016-03-18,Krisha,30000,144822,144822,114822,3,0,2016,382.74
5738,39,2006-09-01,Mutual Appreciation,30000,103509,103509,73509,9,0,2006,245.03
5739,40,2005-04-29,Funny Ha Ha,30000,77070,82698,52698,4,5628,2005,175.66
5740,41,2010-10-15,Down Terrace,30000,9812,9812,-20188,10,0,2010,-67.29333333333334
5741,42,2013-12-31,Paraphobia,30000,0,0,-30000,12,0,2013,-100.0
5742,43,1994-10-19,Clerks,27000,3073428,3894240,3867240,10,820812,1994,14323.111111111111
5743,44,1999-12-24,Pink Narcissus,27000,8231,8231,-18769,12,0,1999,-69.51481481481481
5744,45,2017-01-27,Emily,27000,3547,3547,-23453,1,0,2017,-86.86296296296297
5745,46,1972-06-30,Deep Throat,25000,45000000,45000000,44975000,6,0,1972,179900.0
5746,47,1997-08-01,In the Company of Men,25000,2883661,2883661,2858661,8,0,1997,11434.644
5747,48,2000-01-14,The Terrorist,25000,195043,195043,170043,1,0,2000,680.172
5748,49,2015-09-01,Exeter,25000,0,489792,464792,9,489792,2015,1859.1680000000001
5749,50,2003-06-13,Manito,25000,0,0,-25000,6,0,2003,-100.0
5750,51,2015-04-21,Ten,25000,0,0,-25000,4,0,2015,-100.0
5751,52,2015-12-01,Dutch Kills,25000,0,0,-25000,12,0,2015,-100.0
5752,53,1991-08-01,Slacker,23000,1227508,1227508,1204508,8,0,1991,5236.991304347826
5753,54,2014-12-31,Dry Spell,22000,0,0,-22000,12,0,2014,-100.0
5754,55,2003-12-31,Flywheel,20000,0,0,-20000,12,0,2003,-100.0
5755,56,2013-01-04,All Superheroes Must Die,20000,0,0,-20000,1,0,2013,-100.0
5756,57,2015-04-21,The Front Man,20000,0,0,-20000,4,0,2015,-100.0
5757,58,2003-12-01,Steel Spirit,20000,0,0,-20000,12,0,2003,-100.0
5758,59,2011-11-25,The Ridges,17300,0,0,-17300,11,0,2011,-100.0
5759,60,2006-06-02,The Puffy Chair,15000,194523,195254,180254,6,731,2006,1201.6933333333334
5760,61,2010-04-02,Breaking Upwards,15000,115592,115592,100592,4,0,2010,670.6133333333333
5761,62,2014-12-31,Stories of Our Lives,15000,0,0,-15000,12,0,2014,-100.0
5762,63,1997-04-11,Pink Flamingos,12000,413802,413802,401802,4,0,1997,3348.35
5763,64,2006-04-28,Grip: A Criminal's Story,12000,1336,1336,-10664,4,0,2006,-88.86666666666667
5764,65,2007-12-31,Tin Can Man,12000,0,0,-12000,12,0,2007,-100.0
5765,66,2001-03-09,Dayereh,10000,673780,673780,663780,3,0,2001,6637.8
5766,67,2006-04-28,Clean,10000,138711,138711,128711,4,0,2006,1287.1100000000001
5767,68,2001-07-06,Cure,10000,94596,94596,84596,7,0,2001,845.96
5768,69,2004-05-28,On the Downlow,10000,1987,1987,-8013,5,0,2004,-80.13
5769,70,1996-04-01,Bang,10000,527,527,-9473,4,0,1996,-94.73
5770,71,2008-08-14,The Rise and Fall of Miss Thang,10000,401,401,-9599,8,0,2008,-95.99
5771,72,2015-05-19,Family Motocross,10000,0,0,-10000,5,0,2015,-100.0
5772,73,2012-01-13,Newlyweds,9000,4584,4584,-4416,1,0,2012,-49.06666666666666
5773,74,1993-02-26,El Mariachi,7000,2040920,2041928,2034928,2,1008,1993,29070.4
5774,75,2004-10-08,Primer,7000,424760,841926,834926,10,417166,2004,11927.514285714286
5775,76,2006-05-26,Cavite,7000,70071,71644,64644,5,1573,2006,923.4857142857143
5776,77,2004-12-31,The Mongol King,7000,900,900,-6100,12,0,2004,-87.14285714285714
5777,78,2018-12-31,Red 11,7000,0,0,-7000,12,0,2018,-100.0
5778,79,1999-04-02,Following,6000,48482,240495,234495,4,192013,1999,3908.2500000000005
5779,80,2005-07-13,Return to the Land of Wonders,5000,1338,1338,-3662,7,0,2005,-73.24000000000001
5780,81,2015-09-29,A Plague So Pleasant,1400,0,0,-1400,9,0,2015,-100.0
5781,82,2005-08-05,My Date With Drew,1100,181041,181041,179941,8,0,2005,16358.272727272728
